gltBDF	gltBDF
lrp	lrp
gcvTHP	gcvTHP
kbl_tdh	kbl_tdh
serA	serA
sdaA	sdaA
lysU	lysU
oppABCDF	oppABCDF
gcvA	gcvA
osmC	osmC
gcvR	gcvR
livKHMGF	livKHMGF
ompF	ompF
envY_ompT	envY_ompT
ompR_envZ	ompR_envZ
ompC	ompC
fadL	fadL
stpA	stpA
evgA	evgA
csgDEFG	csgDEFG
fadR	fadR
hns	hns
uspA	uspA
csgBA	csgBA
nlpD_rpoS	nlpD_rpoS
himA	himA
appY	appY
tdcABCDEFG	tdcABCDEFG
lysR	lysR
nhaA	nhaA
osmY	osmY
narZYWV	narZYWV
caiTABCDE	caiTABCDE
cpxAR	cpxAR
glnHPQ	glnHPQ
appCBA	appCBA
dps	dps
alkA	alkA
narGHJI	narGHJI
livJ	livJ
tsr	tsr
lysA	lysA
pspABCDE	pspABCDE
pspF	pspF
proP	proP
adhE	adhE
fliAZY	fliAZY
carAB	carAB
caiF	caiF
htrA	htrA
rpoN	rpoN
arcA	arcA
narL	narL
rotA	rotA
purR	purR
flhDC	flhDC
hypA	hypA
nrfABCDEFG	nrfABCDEFG
flgAMN	flgAMN
fumA	fumA
cpxP	cpxP
focA_pflB	focA_pflB
nirBDC_cysG	nirBDC_cysG
flhBAE	flhBAE
skp_lpxDA_fabZ	skp_lpxDA_fabZ
sdhCDAB_b0725_sucABCD	sdhCDAB_b0725_sucABCD
glcDEFGB	glcDEFGB
fnr	fnr
crp	crp
tnaLAB	tnaLAB
nhaR	nhaR
rpoH	rpoH
fdnGHI	fdnGHI
fliC	fliC
betIBA	betIBA
rpoE_rseABC	rpoE_rseABC
glpD	glpD
aldB	aldB
purMN	purMN
tarTapcheRBYZ	tarTapcheRBYZ
atoC	atoC
sodA	sodA
fliFGHIJK	fliFGHIJK
fixABCX	fixABCX
dcuB_fumB	dcuB_fumB
galETKM	galETKM
glpR	glpR
ibpAB	ibpAB
malI	malI
ecfI	ecfI
cpdB	cpdB
hycABCDEFGH	hycABCDEFGH
galS	galS
cirA	cirA
araBAD	araBAD
cydAB	cydAB
glpFK	glpFK
manXYZ	manXYZ
flgMN	flgMN
lctPRD	lctPRD
dapA_nlpB_purA	dapA_nlpB_purA
speA	speA
fabA	fabA
iclMR	iclMR
mlc	mlc
rhaBAD	rhaBAD
melAB	melAB
acs	acs
ecfH	ecfH
malT	malT
yhfA	yhfA
htpG	htpG
ksgA_epaG_epaH	ksgA_epaG_epaH
xprB_dsbC_recJ	xprB_dsbC_recJ
glgCAP	glgCAP
yhdG_fis	yhdG_fis
leuX	leuX
nagBACD	nagBACD
malK_lamB_malM	malK_lamB_malM
dmsABC	dmsABC
nycA	nycA
yiaKLMNOPQRS	yiaKLMNOPQRS
cvpA_purF_ubiX	cvpA_purF_ubiX
ecfF	ecfF
hflB	hflB
ecfG	ecfG
nupG	nupG
hypABCDE	hypABCDE
ndh	ndh
leuQPV	leuQPV
malEFG	malEFG
purEK	purEK
argU	argU
yiaJ	yiaJ
dadAX	dadAX
flgBCDEFGHIJK	flgBCDEFGHIJK
glpACB	glpACB
malXY	malXY
ecfLM	ecfLM
flgKL	flgKL
serX	serX
fucAO	fucAO
grpE	grpE
narK	narK
ftsQAZ	ftsQAZ
rtcR	rtcR
ptsG	ptsG
rhaSR	rhaSR
motABcheAW	motABcheAW
malZ	malZ
araFG_araH_1H_2	araFG_araH_1H_2
ecpD_htrE	ecpD_htrE
argW	argW
ecfABC	ecfABC
gltA	gltA
aceBAK	aceBAK
ptsHI_crr	ptsHI_crr
cutC	cutC
cytR	cytR
udp	udp
fhlA	fhlA
nagE	nagE
mdh	mdh
ppiA	ppiA
nuoABCEFGHIJKLMN	nuoABCEFGHIJKLMN
mopA	mopA
aspA	aspA
lacZYA	lacZYA
thrU_tyrU_glyT_thrT	thrU_tyrU_glyT_thrT
uppS_cdsA_ecfE	uppS_cdsA_ecfE
yjdHG	yjdHG
dsdXA	dsdXA
dnaA	dnaA
fliE	fliE
cyoABCDE	cyoABCDE
deoCABD	deoCABD
tsx	tsx
ada_alkB	ada_alkB
fkpA	fkpA
nac	nac
pyrD	pyrD
fucPIKUR	fucPIKUR
frdABCD	frdABCD
glyA	glyA
FruR	FruR
pdhR_aceEF_lpdA	pdhR_aceEF_lpdA
purHD	purHD
valUXY_lysV	valUXY_lysV
malPQ	malPQ
glpTQ	glpTQ
fliLMNOPQR	fliLMNOPQR
icdA	icdA
tdcAR	tdcAR
ansB	ansB
lacI	lacI
nrdAB	nrdAB
argR	argR
araE	araE
rob	rob
ecfJ	ecfJ
argE	argE
GalR	GalR
metR	metR
argD	argD
ppsA	ppsA
fur	fur
uhpT	uhpT
betT	betT
aslB	aslB
atoDAB	atoDAB
pykF	pykF
ecfK	ecfK
oxyR	oxyR
araC	araC
deoR	deoR
dnaKJ	dnaKJ
ybiS	ybiS
marRAB	marRAB
rfaDFCL	rfaDFCL
aidB	aidB
fadBA	fadBA
gorA	gorA
glnALG	glnALG
ahpCF	ahpCF
fdhF	fdhF
araJ	araJ
ecfD	ecfD
nfo	nfo
gntKU	gntKU
dsbA	dsbA
rhaT	rhaT
fruBKA	fruBKA
codBA	codBA
yfhD	yfhD
glcC	glcC
rtcAB	rtcAB
zraP	zraP
gntT	gntT
fumC	fumC
cyaA	cyaA
mdoGH	mdoGH
entCEBA	entCEBA
alaWX	alaWX
ostA_surA_pdxA	ostA_surA_pdxA
gntR	gntR
dctA	dctA
rcsA	rcsA
dsdC	dsdC
tonB	tonB
metA	metA
mglBAC	mglBAC
putAP	putAP
serT	serT
uhpA	uhpA
ycfC_purB	ycfC_purB
fpr	fpr
katG	katG
mopB	mopB
epd_pgk	epd_pgk
metH	metH
metJ	metJ
zwf	zwf
fliDST	fliDST
pyrC	pyrC
metT_leuW_glnUW_metU_glnVX	metT_leuW_glnUW_metU_glnVX
himD	himD
purC	purC
pheV	pheV
argI	argI
fepA_entD	fepA_entD
fecIR	fecIR
soxS	soxS
edd_eda	edd_eda
ebgAC	ebgAC
speC	speC
gdhA	gdhA
glgS	glgS
srlAEBD_gutM_srlR_gutQ	srlAEBD_gutM_srlR_gutQ
prsA	prsA
ilvIH	ilvIH
ompA	ompA
glmUS	glmUS
proK	proK
malS	malS
guaBA	guaBA
mdlA	mdlA
fhuACDB	fhuACDB
soxR	soxR
ubiG	ubiG
argCBH	argCBH
argF	argF
torCAD	torCAD
thrW	thrW
wza_wzb_b2060_wcaA_wcaB	wza_wzb_b2060_wcaA_wcaB
htpY	htpY
melR	melR
lpxDA_fabZ	lpxDA_fabZ
aspV	aspV
glnB	glnB
ebgR	ebgR
