aaaD	aaaD
aaeA	aaeA
aaeB	aaeB
aaeR	aaeR
aaeX	aaeX
aas	aas
aat	aat
abgA	abgA
abgB	abgB
abgR	abgR
abgT	abgT
abrB	abrB
accA	accA
accB	accB
accC	accC
accD	accD
aceA	aceA
aceB	aceB
aceE	aceE
aceF	aceF
aceK	aceK
ackA	ackA
acnA	acnA
acnB	acnB
acpH	acpH
acpP	acpP
acpS	acpS
acpT	acpT
acrA	acrA
acrB	acrB
acrD	acrD
acrE	acrE
acrF	acrF
acrR	acrR
acs	acs
actP	actP
ada	ada
add	add
ade	ade
adhE	adhE
adhP	adhP
adiA	adiA
adiC	adiC
adiY	adiY
adk	adk
adrA	adrA
aegA	aegA
aer	aer
aes	aes
afuB	afuB
afuC	afuC
agaA	agaA
agaB	agaB
agaC	agaC
agaD	agaD
agaI	agaI
agaR	agaR
agaS	agaS
agaV	agaV
agaW	agaW
agp	agp
ahpC	ahpC
ahpF	ahpF
aidB	aidB
ais	ais
alaS	alaS
aldA	aldA
aldB	aldB
alkA	alkA
alkB	alkB
allA	allA
allB	allB
allC	allC
allD	allD
allR	allR
allS	allS
alpA	alpA
alr	alr
alsA	alsA
alsB	alsB
alsC	alsC
alsE	alsE
alsK	alsK
alx	alx
amiA	amiA
amiB	amiB
amiC	amiC
amiD	amiD
amn	amn
ampC	ampC
ampD	ampD
ampE	ampE
ampG	ampG
ampH	ampH
amtB	amtB
amyA	amyA
anmK	anmK
ansA	ansA
ansB	ansB
ansP	ansP
apaG	apaG
apaH	apaH
apbE	apbE
aphA	aphA
appA	appA
appB	appB
appC	appC
appY	appY
apt	apt
aqpZ	aqpZ
araA	araA
araB	araB
araC	araC
araD	araD
araE	araE
araF	araF
araG	araG
araH	araH
araJ	araJ
arcA	arcA
arcB	arcB
argA	argA
argB	argB
argC	argC
argD	argD
argE	argE
argF	argF
argG	argG
argH	argH
argI	argI
argK	argK
argO	argO
argP	argP
argR	argR
argS	argS
argT	argT
argU	argU
argW	argW
argX	argX
ariR	ariR
arnA	arnA
arnB	arnB
arnC	arnC
arnD	arnD
arnE	arnE
arnF	arnF
arnT	arnT
aroA	aroA
aroB	aroB
aroC	aroC
aroD	aroD
aroE	aroE
aroF	aroF
aroG	aroG
aroH	aroH
aroK	aroK
aroL	aroL
aroM	aroM
aroP	aroP
arpA	arpA
arpB	arpB
arrD	arrD
arrQ	arrQ
arsB	arsB
arsC	arsC
arsR	arsR
artI	artI
artJ	artJ
artM	artM
artP	artP
artQ	artQ
ascB	ascB
ascF	ascF
ascG	ascG
asd	asd
aslA	aslA
aslB	aslB
asmA	asmA
asnA	asnA
asnB	asnB
asnC	asnC
asnS	asnS
aspA	aspA
aspC	aspC
aspS	aspS
asr	asr
astA	astA
astB	astB
astC	astC
astD	astD
astE	astE
atoA	atoA
atoB	atoB
atoC	atoC
atoD	atoD
atoE	atoE
atoS	atoS
atpA	atpA
atpB	atpB
atpC	atpC
atpD	atpD
atpE	atpE
atpF	atpF
atpG	atpG
atpH	atpH
atpI	atpI
avtA	avtA
azoR	azoR
bacA	bacA
baeR	baeR
baeS	baeS
bamA	bamA
bamB	bamB
bamC	bamC
bamD	bamD
barA	barA
basR	basR
basS	basS
bax	bax
bcp	bcp
bcr	bcr
bcsA	bcsA
bcsB	bcsB
bcsC	bcsC
bcsE	bcsE
bcsF	bcsF
bcsG	bcsG
bcsZ	bcsZ
bdm	bdm
betA	betA
betB	betB
betI	betI
betT	betT
bfd	bfd
bfr	bfr
bglA	bglA
bglB	bglB
bglF	bglF
bglG	bglG
bglH	bglH
bglJ	bglJ
bglX	bglX
bhsA	bhsA
bioA	bioA
bioB	bioB
bioC	bioC
bioD	bioD
bioF	bioF
bioH	bioH
birA	birA
bisC	bisC
blc	blc
blr	blr
bolA	bolA
borD	borD
brnQ	brnQ
bssR	bssR
bssS	bssS
btuB	btuB
btuC	btuC
btuD	btuD
btuE	btuE
btuF	btuF
btuR	btuR
cadA	cadA
cadB	cadB
cadC	cadC
caiA	caiA
caiB	caiB
caiC	caiC
caiD	caiD
caiE	caiE
caiF	caiF
caiT	caiT
can	can
carA	carA
carB	carB
cbl	cbl
cbpA	cbpA
cbpM	cbpM
cbrA	cbrA
cbrB	cbrB
cbrC	cbrC
cca	cca
ccmA	ccmA
ccmB	ccmB
ccmC	ccmC
ccmD	ccmD
ccmE	ccmE
ccmF	ccmF
ccmG	ccmG
ccmH	ccmH
cdaR	cdaR
cdd	cdd
cdh	cdh
cdsA	cdsA
cedA	cedA
cfa	cfa
chaA	chaA
chaB	chaB
chaC	chaC
chbA	chbA
chbB	chbB
chbC	chbC
chbF	chbF
chbG	chbG
chbR	chbR
cheA	cheA
cheB	cheB
cheR	cheR
cheW	cheW
cheY	cheY
cheZ	cheZ
chiA	chiA
cho	cho
chpA	chpA
chpB	chpB
chpR	chpR
chpS	chpS
cirA	cirA
citC	citC
citD	citD
citE	citE
citF	citF
citG	citG
citT	citT
citX	citX
clcA	clcA
clcB	clcB
cld	cld
clpA	clpA
clpB	clpB
clpP	clpP
clpS	clpS
clpX	clpX
cls	cls
cmk	cmk
cmoA	cmoA
cmoB	cmoB
cmr	cmr
cmtA	cmtA
cmtB	cmtB
cnu	cnu
coaA	coaA
coaD	coaD
coaE	coaE
cobB	cobB
cobC	cobC
cobS	cobS
cobT	cobT
cobU	cobU
codA	codA
codB	codB
cof	cof
copA	copA
corA	corA
cpdA	cpdA
cpdB	cpdB
cpsB	cpsB
cpsG	cpsG
cpxA	cpxA
cpxP	cpxP
cpxR	cpxR
crcB	crcB
creA	creA
creB	creB
creC	creC
creD	creD
crl	crl
crp	crp
crr	crr
csdA	csdA
csdE	csdE
csgA	csgA
csgB	csgB
csgC	csgC
csgD	csgD
csgE	csgE
csgF	csgF
csgG	csgG
csiD	csiD
csiE	csiE
csiR	csiR
cspA	cspA
cspB	cspB
cspC	cspC
cspD	cspD
cspE	cspE
cspF	cspF
cspG	cspG
cspH	cspH
cspI	cspI
csrA	csrA
csrB	csrB
csrC	csrC
csrD	csrD
cstA	cstA
cueO	cueO
cueR	cueR
cusA	cusA
cusB	cusB
cusC	cusC
cusF	cusF
cusR	cusR
cusS	cusS
cutA	cutA
cutC	cutC
cvpA	cvpA
cvrA	cvrA
cyaA	cyaA
cyaR	cyaR
cyaY	cyaY
cybB	cybB
cybC	cybC
cycA	cycA
cydA	cydA
cydB	cydB
cydC	cydC
cydD	cydD
cynR	cynR
cynS	cynS
cynT	cynT
cynX	cynX
cyoA	cyoA
cyoB	cyoB
cyoC	cyoC
cyoD	cyoD
cyoE	cyoE
cysA	cysA
cysB	cysB
cysC	cysC
cysD	cysD
cysE	cysE
cysG	cysG
cysH	cysH
cysI	cysI
cysJ	cysJ
cysK	cysK
cysM	cysM
cysN	cysN
cysP	cysP
cysQ	cysQ
cysS	cysS
cysT	cysT
cysU	cysU
cysW	cysW
cysZ	cysZ
cytR	cytR
dacA	dacA
dacB	dacB
dacC	dacC
dacD	dacD
dadA	dadA
dadX	dadX
damX	damX
dam	dam
dapA	dapA
dapB	dapB
dapD	dapD
dapE	dapE
dapF	dapF
dbpA	dbpA
dcd	dcd
dcm	dcm
dcp	dcp
dcrB	dcrB
dctA	dctA
dctR	dctR
dcuA	dcuA
dcuB	dcuB
dcuC	dcuC
dcuD	dcuD
dcuR	dcuR
dcuS	dcuS
dcyD	dcyD
ddlA	ddlA
ddlB	ddlB
ddpA	ddpA
ddpB	ddpB
ddpC	ddpC
ddpD	ddpD
ddpF	ddpF
ddpX	ddpX
deaD	deaD
dedA	dedA
dedD	dedD
def	def
degP	degP
degQ	degQ
degS	degS
deoA	deoA
deoB	deoB
deoC	deoC
deoD	deoD
deoR	deoR
der	der
dfp	dfp
dgkA	dgkA
dgoD	dgoD
dgoK	dgoK
dgoR	dgoR
dgoT	dgoT
dgsA	dgsA
dgt	dgt
dhaK	dhaK
dhaL	dhaL
dhaM	dhaM
dhaR	dhaR
diaA	diaA
dicA	dicA
dicB	dicB
dicC	dicC
dicF	dicF
dinB	dinB
dinD	dinD
dinF	dinF
dinG	dinG
dinI	dinI
dinJ	dinJ
dinQ	dinQ
dipZ	dipZ
djlA	djlA
djlB	djlB
djlC	djlC
dkgA	dkgA
dkgB	dkgB
dksA	dksA
dld	dld
dmsA	dmsA
dmsB	dmsB
dmsC	dmsC
dmsD	dmsD
dnaA	dnaA
dnaB	dnaB
dnaC	dnaC
dnaE	dnaE
dnaG	dnaG
dnaJ	dnaJ
dnaK	dnaK
dnaN	dnaN
dnaQ	dnaQ
dnaT	dnaT
dnaX	dnaX
dos	dos
dpiA	dpiA
dpiB	dpiB
dppA	dppA
dppB	dppB
dppC	dppC
dppD	dppD
dppF	dppF
dps	dps
dsbA	dsbA
dsbB	dsbB
dsbC	dsbC
dsbG	dsbG
dsdA	dsdA
dsdC	dsdC
dsdX	dsdX
dsrA	dsrA
dsrB	dsrB
dtd	dtd
dtpB	dtpB
dusA	dusA
dusB	dusB
dusC	dusC
dut	dut
dxr	dxr
dxs	dxs
eaeH	eaeH
eamA	eamA
eamB	eamB
ebgA	ebgA
ebgC	ebgC
ebgR	ebgR
ecnA	ecnA
ecnB	ecnB
eco	eco
ecpD	ecpD
eda	eda
edd	edd
efeB	efeB
efeO	efeO
efeU	efeU
efp	efp
elaA	elaA
elaB	elaB
elaD	elaD
elbA	elbA
elbB	elbB
emrA	emrA
emrB	emrB
emrD	emrD
emrE	emrE
emrK	emrK
emrY	emrY
emtA	emtA
endA	endA
eno	eno
entA	entA
entB	entB
entC	entC
entD	entD
entE	entE
entF	entF
entS	entS
envC	envC
envR	envR
envY	envY
envZ	envZ
epd	epd
eptA	eptA
eptB	eptB
era	era
erfK	erfK
erpA	erpA
essD	essD
essQ	essQ
etk	etk
etp	etp
eutA	eutA
eutB	eutB
eutC	eutC
eutD	eutD
eutE	eutE
eutG	eutG
eutH	eutH
eutJ	eutJ
eutK	eutK
eutL	eutL
eutM	eutM
eutN	eutN
eutP	eutP
eutQ	eutQ
eutR	eutR
eutS	eutS
eutT	eutT
evgA	evgA
evgS	evgS
exbB	exbB
exbD	exbD
exoD	exoD
exoX	exoX
exuR	exuR
exuT	exuT
fabA	fabA
fabB	fabB
fabD	fabD
fabF	fabF
fabG	fabG
fabH	fabH
fabI	fabI
fabR	fabR
fabZ	fabZ
fadA	fadA
fadB	fadB
fadD	fadD
fadE	fadE
fadH	fadH
fadI	fadI
fadJ	fadJ
fadK	fadK
fadL	fadL
fadR	fadR
fbaA	fbaA
fbaB	fbaB
fbp	fbp
fcl	fcl
fdhD	fdhD
fdhE	fdhE
fdhF	fdhF
fdnG	fdnG
fdnH	fdnH
fdnI	fdnI
fdoG	fdoG
fdoH	fdoH
fdoI	fdoI
fdrA	fdrA
fdx	fdx
feaB	feaB
feaR	feaR
fecA	fecA
fecB	fecB
fecC	fecC
fecD	fecD
fecE	fecE
fecI	fecI
fecR	fecR
feoA	feoA
feoB	feoB
feoC	feoC
fepA	fepA
fepB	fepB
fepC	fepC
fepD	fepD
fepE	fepE
fepG	fepG
fes	fes
ffh	ffh
ffs	ffs
fhlA	fhlA
fhuA	fhuA
fhuB	fhuB
fhuC	fhuC
fhuD	fhuD
fhuE	fhuE
fhuF	fhuF
fic	fic
fieF	fieF
fimA	fimA
fimB	fimB
fimC	fimC
fimD	fimD
fimE	fimE
fimF	fimF
fimG	fimG
fimH	fimH
fimI	fimI
fimZ	fimZ
fis	fis
fiu	fiu
fixA	fixA
fixB	fixB
fixC	fixC
fixX	fixX
fklB	fklB
fkpA	fkpA
fkpB	fkpB
fldA	fldA
fldB	fldB
flgA	flgA
flgB	flgB
flgC	flgC
flgD	flgD
flgE	flgE
flgF	flgF
flgG	flgG
flgH	flgH
flgI	flgI
flgJ	flgJ
flgK	flgK
flgL	flgL
flgM	flgM
flgN	flgN
flhA	flhA
flhB	flhB
flhC	flhC
flhD	flhD
flhE	flhE
fliA	fliA
fliC	fliC
fliD	fliD
fliE	fliE
fliF	fliF
fliG	fliG
fliH	fliH
fliI	fliI
fliJ	fliJ
fliK	fliK
fliL	fliL
fliM	fliM
fliN	fliN
fliO	fliO
fliP	fliP
fliQ	fliQ
fliR	fliR
fliS	fliS
fliT	fliT
fliY	fliY
fliZ	fliZ
flk	flk
flu	flu
flxA	flxA
fmt	fmt
fnr	fnr
focA	focA
focB	focB
folA	folA
folB	folB
folC	folC
folD	folD
folE	folE
folK	folK
folM	folM
folP	folP
folX	folX
fpr	fpr
frc	frc
frdA	frdA
frdB	frdB
frdC	frdC
frdD	frdD
fre	fre
frlA	frlA
frlB	frlB
frlC	frlC
frlD	frlD
frlR	frlR
frmA	frmA
frmB	frmB
frmR	frmR
frr	frr
frsA	frsA
fruA	fruA
fruB	fruB
fruK	fruK
fruR	fruR
frvA	frvA
frvB	frvB
frvR	frvR
frvX	frvX
frwB	frwB
frwC	frwC
frwD	frwD
fryA	fryA
fryB	fryB
fryC	fryC
fsaA	fsaA
fsaB	fsaB
fsr	fsr
ftnA	ftnA
ftnB	ftnB
ftsA	ftsA
ftsB	ftsB
ftsE	ftsE
ftsI	ftsI
ftsK	ftsK
ftsL	ftsL
ftsN	ftsN
ftsP	ftsP
ftsQ	ftsQ
ftsW	ftsW
ftsX	ftsX
ftsY	ftsY
ftsZ	ftsZ
fucA	fucA
fucI	fucI
fucK	fucK
fucO	fucO
fucP	fucP
fucR	fucR
fucU	fucU
fumA	fumA
fumB	fumB
fumC	fumC
fur	fur
fusA	fusA
fxsA	fxsA
gabD	gabD
gabP	gabP
gabT	gabT
gadA	gadA
gadB	gadB
gadC	gadC
gadE	gadE
gadW	gadW
gadX	gadX
gadY	gadY
galE	galE
galF	galF
galK	galK
galM	galM
galP	galP
galR	galR
galS	galS
galT	galT
galU	galU
gapA	gapA
gapC	gapC
garD	garD
garK	garK
garL	garL
garP	garP
garR	garR
gatA	gatA
gatB	gatB
gatC	gatC
gatD	gatD
gatR	gatR
gatY	gatY
gatZ	gatZ
gcd	gcd
gcl	gcl
gcvA	gcvA
gcvB	gcvB
gcvH	gcvH
gcvP	gcvP
gcvR	gcvR
gcvT	gcvT
gdhA	gdhA
gfcA	gfcA
gfcB	gfcB
gfcC	gfcC
gfcD	gfcD
gfcE	gfcE
ggt	ggt
ghrA	ghrA
ghrB	ghrB
gidB	gidB
glcA	glcA
glcB	glcB
glcC	glcC
glcD	glcD
glcF	glcF
glcG	glcG
gldA	gldA
glf	glf
glgA	glgA
glgB	glgB
glgC	glgC
glgP	glgP
glgS	glgS
glgX	glgX
glk	glk
glmM	glmM
glmS	glmS
glmU	glmU
glmY	glmY
glmZ	glmZ
glnA	glnA
glnB	glnB
glnD	glnD
glnE	glnE
glnG	glnG
glnH	glnH
glnK	glnK
glnL	glnL
glnP	glnP
glnQ	glnQ
glnS	glnS
gloA	gloA
gloB	gloB
glpA	glpA
glpB	glpB
glpC	glpC
glpD	glpD
glpE	glpE
glpF	glpF
glpG	glpG
glpK	glpK
glpQ	glpQ
glpR	glpR
glpT	glpT
glpX	glpX
gltA	gltA
gltB	gltB
gltD	gltD
gltF	gltF
gltI	gltI
gltJ	gltJ
gltK	gltK
gltL	gltL
gltP	gltP
gltS	gltS
gltX	gltX
glvC	glvC
glvG	glvG
glxK	glxK
glxR	glxR
glyA	glyA
glyQ	glyQ
glyS	glyS
glyT	glyT
glyU	glyU
gmd	gmd
gmhB	gmhB
gmk	gmk
gmm	gmm
gmr	gmr
gnd	gnd
gnsA	gnsA
gnsB	gnsB
gntK	gntK
gntP	gntP
gntR	gntR
gntT	gntT
gntU	gntU
gntX	gntX
gor	gor
gph	gph
gpmA	gpmA
gpmM	gpmM
gpp	gpp
gpsA	gpsA
gpt	gpt
greA	greA
greB	greB
groL	groL
groS	groS
grpE	grpE
grxA	grxA
grxB	grxB
grxC	grxC
grxD	grxD
gshA	gshA
gshB	gshB
gsiA	gsiA
gsiB	gsiB
gsiC	gsiC
gsiD	gsiD
gsk	gsk
gspA	gspA
gspB	gspB
gspC	gspC
gspD	gspD
gspE	gspE
gspF	gspF
gspG	gspG
gspH	gspH
gspI	gspI
gspJ	gspJ
gspK	gspK
gspL	gspL
gspM	gspM
gspO	gspO
gsp	gsp
gst	gst
guaA	guaA
guaB	guaB
guaC	guaC
guaD	guaD
gudD	gudD
gudP	gudP
gudX	gudX
gutM	gutM
gutQ	gutQ
gyrA	gyrA
gyrB	gyrB
hcaB	hcaB
hcaC	hcaC
hcaD	hcaD
hcaE	hcaE
hcaF	hcaF
hcaR	hcaR
hcaT	hcaT
hchA	hchA
hcp	hcp
hcr	hcr
hda	hda
hdeA	hdeA
hdeB	hdeB
hdeD	hdeD
hdfR	hdfR
hdhA	hdhA
helD	helD
hemA	hemA
hemB	hemB
hemC	hemC
hemD	hemD
hemE	hemE
hemF	hemF
hemG	hemG
hemH	hemH
hemL	hemL
hemN	hemN
hemX	hemX
hemY	hemY
hepA	hepA
hflB	hflB
hflC	hflC
hflD	hflD
hflK	hflK
hflX	hflX
hfq	hfq
hha	hha
hinT	hinT
hipA	hipA
hipB	hipB
hisA	hisA
hisB	hisB
hisC	hisC
hisD	hisD
hisF	hisF
hisG	hisG
hisH	hisH
hisI	hisI
hisJ	hisJ
hisL	hisL
hisM	hisM
hisP	hisP
hisQ	hisQ
hisR	hisR
hisS	hisS
hlyE	hlyE
hmp	hmp
hns	hns
hofB	hofB
hofC	hofC
hofM	hofM
hofN	hofN
hofO	hofO
hofP	hofP
hofQ	hofQ
hokB	hokB
hokD	hokD
hokE	hokE
holA	holA
holB	holB
holC	holC
holD	holD
holE	holE
hpf	hpf
hpt	hpt
hrpA	hrpA
hrpB	hrpB
hscA	hscA
hscB	hscB
hscC	hscC
hsdM	hsdM
hsdR	hsdR
hsdS	hsdS
hslJ	hslJ
hslO	hslO
hslR	hslR
hslU	hslU
hslV	hslV
hspQ	hspQ
hsrA	hsrA
htpG	htpG
htpX	htpX
htrE	htrE
htrG	htrG
htrL	htrL
hupA	hupA
hupB	hupB
hyaA	hyaA
hyaB	hyaB
hyaC	hyaC
hyaD	hyaD
hyaE	hyaE
hyaF	hyaF
hybA	hybA
hybB	hybB
hybC	hybC
hybD	hybD
hybE	hybE
hybF	hybF
hybG	hybG
hybO	hybO
hycA	hycA
hycB	hycB
hycC	hycC
hycD	hycD
hycE	hycE
hycF	hycF
hycG	hycG
hycH	hycH
hycI	hycI
hydN	hydN
hyfA	hyfA
hyfB	hyfB
hyfC	hyfC
hyfD	hyfD
hyfE	hyfE
hyfF	hyfF
hyfG	hyfG
hyfH	hyfH
hyfI	hyfI
hyfJ	hyfJ
hyfR	hyfR
hyi	hyi
hypA	hypA
hypB	hypB
hypC	hypC
hypD	hypD
hypE	hypE
hypF	hypF
hyuA	hyuA
iaaA	iaaA
iadA	iadA
iap	iap
ibpA	ibpA
ibpB	ibpB
icdC	icdC
icd	icd
iclR	iclR
idi	idi
idnD	idnD
idnK	idnK
idnO	idnO
idnR	idnR
idnT	idnT
ihfA	ihfA
ihfB	ihfB
ileS	ileS
ileX	ileX
ileY	ileY
ilvA	ilvA
ilvB	ilvB
ilvC	ilvC
ilvD	ilvD
ilvE	ilvE
ilvG	ilvG
ilvH	ilvH
ilvI	ilvI
ilvL	ilvL
ilvM	ilvM
ilvN	ilvN
ilvY	ilvY
imp	imp
inaA	inaA
infA	infA
infB	infB
infC	infC
insA	insA
insB	insB
insD	insD
insG	insG
insH	insH
insJ	insJ
insK	insK
insM	insM
insN	insN
insO	insO
insX	insX
insZ	insZ
intA	intA
intB	intB
intD	intD
intE	intE
intF	intF
intG	intG
intQ	intQ
intR	intR
intS	intS
intZ	intZ
iraP	iraP
iscA	iscA
iscR	iscR
iscS	iscS
iscU	iscU
iscX	iscX
ispA	ispA
ispB	ispB
ispD	ispD
ispE	ispE
ispF	ispF
ispG	ispG
ispH	ispH
ispU	ispU
isrA	isrA
isrB	isrB
isrC	isrC
istR	istR
ivbL	ivbL
ivy	ivy
katE	katE
katG	katG
kbaY	kbaY
kbaZ	kbaZ
kbl	kbl
kch	kch
kdgK	kdgK
kdgR	kdgR
kdgT	kdgT
kdpA	kdpA
kdpB	kdpB
kdpC	kdpC
kdpD	kdpD
kdpE	kdpE
kdpF	kdpF
kdsA	kdsA
kdsB	kdsB
kdsC	kdsC
kdsD	kdsD
kduD	kduD
kduI	kduI
kefA	kefA
kefB	kefB
kefC	kefC
kefF	kefF
kefG	kefG
kgtP	kgtP
kilR	kilR
kptA	kptA
ksgA	ksgA
kup	kup
lacA	lacA
lacI	lacI
lacY	lacY
lacZ	lacZ
lafU	lafU
lamB	lamB
lar	lar
ldcA	ldcA
ldcC	ldcC
ldhA	ldhA
ldrD	ldrD
lepA	lepA
lepB	lepB
leuA	leuA
leuB	leuB
leuC	leuC
leuD	leuD
leuE	leuE
leuL	leuL
leuO	leuO
leuP	leuP
leuS	leuS
leuU	leuU
leuW	leuW
leuX	leuX
leuZ	leuZ
lexA	lexA
lfhA	lfhA
lgt	lgt
lhr	lhr
ligA	ligA
ligB	ligB
ligT	ligT
lipA	lipA
lipB	lipB
lit	lit
livF	livF
livG	livG
livH	livH
livJ	livJ
livK	livK
livM	livM
lldD	lldD
lldP	lldP
lldR	lldR
lnt	lnt
lolA	lolA
lolB	lolB
lolC	lolC
lolD	lolD
lolE	lolE
lomR	lomR
lon	lon
lpcA	lpcA
lpd	lpd
lplA	lplA
lplT	lplT
lpp	lpp
lptA	lptA
lptB	lptB
lpxA	lpxA
lpxB	lpxB
lpxC	lpxC
lpxD	lpxD
lpxH	lpxH
lpxK	lpxK
lpxL	lpxL
lpxM	lpxM
lpxP	lpxP
lpxT	lpxT
lrhA	lrhA
lrp	lrp
lspA	lspA
lsrA	lsrA
lsrB	lsrB
lsrC	lsrC
lsrD	lsrD
lsrF	lsrF
lsrG	lsrG
lsrK	lsrK
lsrR	lsrR
ltaE	ltaE
luxS	luxS
lysA	lysA
lysC	lysC
lysP	lysP
lysR	lysR
lysS	lysS
lysU	lysU
lyx	lyx
maa	maa
macA	macA
macB	macB
maeA	maeA
maeB	maeB
mak	mak
malE	malE
malF	malF
malG	malG
malI	malI
malK	malK
malM	malM
malP	malP
malQ	malQ
malS	malS
malT	malT
malX	malX
malY	malY
malZ	malZ
manA	manA
manX	manX
manY	manY
manZ	manZ
maoC	maoC
map	map
marA	marA
marB	marB
marC	marC
marR	marR
matA	matA
matB	matB
matC	matC
mazG	mazG
mcbA	mcbA
mcbR	mcbR
mcrA	mcrA
mcrB	mcrB
mcrC	mcrC
mdaB	mdaB
mdh	mdh
mdlA	mdlA
mdlB	mdlB
mdoB	mdoB
mdoC	mdoC
mdoD	mdoD
mdoG	mdoG
mdoH	mdoH
mdtA	mdtA
mdtB	mdtB
mdtC	mdtC
mdtD	mdtD
mdtE	mdtE
mdtF	mdtF
mdtG	mdtG
mdtH	mdtH
mdtI	mdtI
mdtJ	mdtJ
mdtK	mdtK
mdtL	mdtL
mdtM	mdtM
mdtN	mdtN
mdtO	mdtO
mdtP	mdtP
mdtQ	mdtQ
melA	melA
melB	melB
melR	melR
menA	menA
menB	menB
menC	menC
menD	menD
menE	menE
menF	menF
mepA	mepA
metA	metA
metB	metB
metC	metC
metE	metE
metF	metF
metG	metG
metH	metH
metI	metI
metJ	metJ
metK	metK
metL	metL
metN	metN
metQ	metQ
metR	metR
metY	metY
mfd	mfd
mglA	mglA
mglB	mglB
mglC	mglC
mgrB	mgrB
mgsA	mgsA
mgtA	mgtA
mhpA	mhpA
mhpB	mhpB
mhpC	mhpC
mhpD	mhpD
mhpE	mhpE
mhpF	mhpF
mhpR	mhpR
mhpT	mhpT
miaA	miaA
miaB	miaB
micA	micA
micC	micC
micF	micF
minC	minC
minD	minD
minE	minE
mioC	mioC
mipA	mipA
mlrA	mlrA
mltA	mltA
mltB	mltB
mltC	mltC
mltD	mltD
mltF	mltF
mmuM	mmuM
mmuP	mmuP
mngA	mngA
mngB	mngB
mngR	mngR
mnmA	mnmA
mnmC	mnmC
mnmE	mnmE
mnmG	mnmG
mntH	mntH
mntR	mntR
moaA	moaA
moaB	moaB
moaC	moaC
moaD	moaD
moaE	moaE
mobA	mobA
mobB	mobB
modA	modA
modB	modB
modC	modC
modE	modE
modF	modF
moeA	moeA
moeB	moeB
mog	mog
mokA	mokA
mokB	mokB
mokC	mokC
motA	motA
motB	motB
mpaA	mpaA
mpl	mpl
mppA	mppA
mprA	mprA
mqo	mqo
mqsR	mqsR
mraW	mraW
mraY	mraY
mraZ	mraZ
mrcA	mrcA
mrcB	mrcB
mrdA	mrdA
mrdB	mrdB
mreB	mreB
mreC	mreC
mreD	mreD
mrp	mrp
mrr	mrr
msbA	msbA
mscL	mscL
mscS	mscS
msrA	msrA
msrB	msrB
msyB	msyB
mtfA	mtfA
mtgA	mtgA
mtlA	mtlA
mtlD	mtlD
mtlR	mtlR
mtn	mtn
mtr	mtr
mug	mug
mukB	mukB
mukE	mukE
mukF	mukF
murA	murA
murB	murB
murC	murC
murD	murD
murE	murE
murF	murF
murG	murG
murI	murI
murP	murP
murQ	murQ
mutH	mutH
mutL	mutL
mutM	mutM
mutS	mutS
mutT	mutT
mutY	mutY
nac	nac
nadA	nadA
nadB	nadB
nadC	nadC
nadD	nadD
nadE	nadE
nadK	nadK
nadR	nadR
nagA	nagA
nagB	nagB
nagC	nagC
nagD	nagD
nagE	nagE
nagK	nagK
nagZ	nagZ
nanA	nanA
nanC	nanC
nanE	nanE
nanK	nanK
nanM	nanM
nanR	nanR
nanT	nanT
napA	napA
napB	napB
napC	napC
napD	napD
napF	napF
napG	napG
napH	napH
narG	narG
narH	narH
narI	narI
narJ	narJ
narK	narK
narL	narL
narP	narP
narQ	narQ
narU	narU
narV	narV
narW	narW
narX	narX
narY	narY
narZ	narZ
ndh	ndh
ndk	ndk
nei	nei
nemA	nemA
nemR	nemR
nepI	nepI
nfi	nfi
nfo	nfo
nfrA	nfrA
nfrB	nfrB
nfsA	nfsA
nfsB	nfsB
nfuA	nfuA
nhaA	nhaA
nhaB	nhaB
nhaR	nhaR
nhoA	nhoA
nikA	nikA
nikB	nikB
nikC	nikC
nikD	nikD
nikE	nikE
nikR	nikR
ninE	ninE
nirB	nirB
nirC	nirC
nirD	nirD
nlpA	nlpA
nlpC	nlpC
nlpD	nlpD
nlpE	nlpE
nlpI	nlpI
nmpC	nmpC
norR	norR
norV	norV
norW	norW
npr	npr
nrdA	nrdA
nrdB	nrdB
nrdD	nrdD
nrdE	nrdE
nrdF	nrdF
nrdG	nrdG
nrdH	nrdH
nrdI	nrdI
nrdR	nrdR
nrfA	nrfA
nrfB	nrfB
nrfC	nrfC
nrfD	nrfD
nrfE	nrfE
nrfF	nrfF
nrfG	nrfG
nsrR	nsrR
nth	nth
nudB	nudB
nudC	nudC
nudE	nudE
nudF	nudF
nudG	nudG
nudI	nudI
nudJ	nudJ
nudK	nudK
nudL	nudL
nuoA	nuoA
nuoB	nuoB
nuoC	nuoC
nuoE	nuoE
nuoF	nuoF
nuoG	nuoG
nuoH	nuoH
nuoI	nuoI
nuoJ	nuoJ
nuoK	nuoK
nuoL	nuoL
nuoM	nuoM
nuoN	nuoN
nupC	nupC
nupG	nupG
nupX	nupX
nusA	nusA
nusB	nusB
nusG	nusG
obgE	obgE
ogrK	ogrK
ogt	ogt
ompA	ompA
ompC	ompC
ompF	ompF
ompG	ompG
ompL	ompL
ompN	ompN
ompR	ompR
ompT	ompT
ompW	ompW
ompX	ompX
omrA	omrA
omrB	omrB
oppA	oppA
oppB	oppB
oppC	oppC
oppD	oppD
oppF	oppF
orn	orn
osmB	osmB
osmC	osmC
osmE	osmE
osmF	osmF
osmY	osmY
otsA	otsA
otsB	otsB
oxc	oxc
oxyR	oxyR
oxyS	oxyS
paaA	paaA
paaB	paaB
paaC	paaC
paaD	paaD
paaE	paaE
paaF	paaF
paaG	paaG
paaH	paaH
paaI	paaI
paaJ	paaJ
paaK	paaK
paaX	paaX
paaY	paaY
pabA	pabA
pabB	pabB
pabC	pabC
pagB	pagB
pagP	pagP
pal	pal
panB	panB
panC	panC
panD	panD
panE	panE
panF	panF
parC	parC
parE	parE
pauD	pauD
pawZ	pawZ
pbl	pbl
pbpC	pbpC
pbpG	pbpG
pck	pck
pcm	pcm
pcnB	pcnB
pdhR	pdhR
pdxA	pdxA
pdxB	pdxB
pdxH	pdxH
pdxJ	pdxJ
pdxK	pdxK
pdxY	pdxY
peaD	peaD
pepA	pepA
pepB	pepB
pepD	pepD
pepE	pepE
pepN	pepN
pepP	pepP
pepQ	pepQ
pepT	pepT
perR	perR
pfkA	pfkA
pfkB	pfkB
pflA	pflA
pflB	pflB
pflC	pflC
pflD	pflD
pgaA	pgaA
pgaB	pgaB
pgaC	pgaC
pgaD	pgaD
pgi	pgi
pgk	pgk
pgl	pgl
pgm	pgm
pgpA	pgpA
pgpB	pgpB
pgsA	pgsA
pheA	pheA
pheL	pheL
pheM	pheM
pheP	pheP
pheS	pheS
pheT	pheT
phnC	phnC
phnD	phnD
phnE	phnE
phnF	phnF
phnG	phnG
phnH	phnH
phnI	phnI
phnJ	phnJ
phnK	phnK
phnL	phnL
phnM	phnM
phnN	phnN
phnO	phnO
phnP	phnP
phoA	phoA
phoB	phoB
phoE	phoE
phoH	phoH
phoP	phoP
phoQ	phoQ
phoR	phoR
phoU	phoU
php	php
phr	phr
pinE	pinE
pinH	pinH
pitA	pitA
pitB	pitB
pldA	pldA
pldB	pldB
plsB	plsB
plsC	plsC
plsX	plsX
pmbA	pmbA
pmrD	pmrD
pncA	pncA
pncB	pncB
pnp	pnp
pntA	pntA
pntB	pntB
pnuC	pnuC
polA	polA
polB	polB
potA	potA
potB	potB
potC	potC
potD	potD
potE	potE
potF	potF
potG	potG
potH	potH
potI	potI
poxA	poxA
poxB	poxB
ppa	ppa
ppc	ppc
ppdA	ppdA
ppdB	ppdB
ppdC	ppdC
ppdD	ppdD
pphA	pphA
pphB	pphB
ppiA	ppiA
ppiB	ppiB
ppiC	ppiC
ppiD	ppiD
ppk	ppk
pppA	pppA
pps	pps
pptA	pptA
ppx	ppx
pqiA	pqiA
pqiB	pqiB
pqqL	pqqL
prc	prc
prfA	prfA
prfB	prfB
prfC	prfC
prfH	prfH
priA	priA
priB	priB
priC	priC
prkB	prkB
prlC	prlC
prmA	prmA
prmB	prmB
prmC	prmC
proA	proA
proB	proB
proC	proC
proK	proK
proL	proL
proM	proM
proP	proP
proQ	proQ
proS	proS
proV	proV
proW	proW
proX	proX
proY	proY
prpB	prpB
prpC	prpC
prpD	prpD
prpE	prpE
prpR	prpR
prs	prs
psd	psd
psiE	psiE
psiF	psiF
pspA	pspA
pspB	pspB
pspC	pspC
pspD	pspD
pspE	pspE
pspF	pspF
pspG	pspG
psrD	psrD
psrN	psrN
psrO	psrO
pssA	pssA
pstA	pstA
pstB	pstB
pstC	pstC
pstS	pstS
psuG	psuG
psuK	psuK
psuT	psuT
pta	pta
pth	pth
ptrA	ptrA
ptrB	ptrB
ptsA	ptsA
ptsG	ptsG
ptsH	ptsH
ptsI	ptsI
ptsN	ptsN
ptsP	ptsP
purA	purA
purB	purB
purC	purC
purD	purD
purE	purE
purF	purF
purH	purH
purK	purK
purL	purL
purM	purM
purN	purN
purR	purR
purT	purT
purU	purU
putA	putA
putP	putP
puuA	puuA
puuB	puuB
puuC	puuC
puuD	puuD
puuE	puuE
puuP	puuP
puuR	puuR
pykA	pykA
pykF	pykF
pyrB	pyrB
pyrC	pyrC
pyrD	pyrD
pyrE	pyrE
pyrF	pyrF
pyrG	pyrG
pyrH	pyrH
pyrI	pyrI
pyrL	pyrL
qmcA	qmcA
qor	qor
qseB	qseB
qseC	qseC
queA	queA
queC	queC
queF	queF
quuD	quuD
quuQ	quuQ
racC	racC
racR	racR
radA	radA
raiA	raiA
rarA	rarA
rarD	rarD
ravA	ravA
rbbA	rbbA
rbfA	rbfA
rbn	rbn
rbsA	rbsA
rbsB	rbsB
rbsC	rbsC
rbsD	rbsD
rbsK	rbsK
rbsR	rbsR
rcnA	rcnA
rcnR	rcnR
rcsA	rcsA
rcsB	rcsB
rcsC	rcsC
rcsD	rcsD
rcsF	rcsF
rdgB	rdgB
rdgC	rdgC
rdlA	rdlA
rdlD	rdlD
rdoA	rdoA
recA	recA
recB	recB
recC	recC
recD	recD
recE	recE
recF	recF
recG	recG
recJ	recJ
recN	recN
recO	recO
recQ	recQ
recR	recR
recT	recT
recX	recX
relA	relA
relB	relB
relE	relE
rem	rem
renD	renD
rep	rep
rfaB	rfaB
rfaC	rfaC
rfaD	rfaD
rfaE	rfaE
rfaF	rfaF
rfaG	rfaG
rfaH	rfaH
rfaI	rfaI
rfaJ	rfaJ
rfaL	rfaL
rfaP	rfaP
rfaQ	rfaQ
rfaS	rfaS
rfaY	rfaY
rfaZ	rfaZ
rfbA	rfbA
rfbB	rfbB
rfbC	rfbC
rfbD	rfbD
rfbX	rfbX
rfc	rfc
rfe	rfe
rffA	rffA
rffC	rffC
rffD	rffD
rffE	rffE
rffG	rffG
rffH	rffH
rffM	rffM
rhaA	rhaA
rhaB	rhaB
rhaD	rhaD
rhaM	rhaM
rhaR	rhaR
rhaS	rhaS
rhaT	rhaT
rhlB	rhlB
rhlE	rhlE
rho	rho
rhsA	rhsA
rhsB	rhsB
rhsC	rhsC
rhsD	rhsD
rhsE	rhsE
rhtA	rhtA
rhtB	rhtB
rhtC	rhtC
ribA	ribA
ribB	ribB
ribC	ribC
ribD	ribD
ribE	ribE
ribF	ribF
rihA	rihA
rihB	rihB
rihC	rihC
rimI	rimI
rimJ	rimJ
rimK	rimK
rimL	rimL
rimM	rimM
rimN	rimN
rlmB	rlmB
rlmF	rlmF
rlmG	rlmG
rlmL	rlmL
rlmN	rlmN
rlpA	rlpA
rlpB	rlpB
rluA	rluA
rluB	rluB
rluC	rluC
rluD	rluD
rluE	rluE
rluF	rluF
rmf	rmf
rmuC	rmuC
rna	rna
rnb	rnb
rnc	rnc
rnd	rnd
rne	rne
rng	rng
rnhA	rnhA
rnhB	rnhB
rnk	rnk
rnlA	rnlA
rnpA	rnpA
rnpB	rnpB
rnr	rnr
rnt	rnt
rob	rob
rof	rof
rpe	rpe
rph	rph
rpiA	rpiA
rpiB	rpiB
rpiR	rpiR
rplA	rplA
rplB	rplB
rplC	rplC
rplD	rplD
rplE	rplE
rplF	rplF
rplI	rplI
rplJ	rplJ
rplK	rplK
rplL	rplL
rplM	rplM
rplN	rplN
rplO	rplO
rplP	rplP
rplQ	rplQ
rplR	rplR
rplS	rplS
rplT	rplT
rplU	rplU
rplV	rplV
rplW	rplW
rplX	rplX
rplY	rplY
rpmA	rpmA
rpmB	rpmB
rpmC	rpmC
rpmD	rpmD
rpmE	rpmE
rpmF	rpmF
rpmG	rpmG
rpmH	rpmH
rpmI	rpmI
rpmJ	rpmJ
rpoA	rpoA
rpoB	rpoB
rpoC	rpoC
rpoD	rpoD
rpoE	rpoE
rpoH	rpoH
rpoN	rpoN
rpoS	rpoS
rpoZ	rpoZ
rppH	rppH
rprA	rprA
rpsA	rpsA
rpsB	rpsB
rpsC	rpsC
rpsD	rpsD
rpsE	rpsE
rpsF	rpsF
rpsG	rpsG
rpsH	rpsH
rpsI	rpsI
rpsJ	rpsJ
rpsK	rpsK
rpsL	rpsL
rpsM	rpsM
rpsN	rpsN
rpsO	rpsO
rpsP	rpsP
rpsQ	rpsQ
rpsR	rpsR
rpsS	rpsS
rpsT	rpsT
rpsU	rpsU
rraA	rraA
rraB	rraB
rrfA	rrfA
rrlA	rrlA
rrmA	rrmA
rrmJ	rrmJ
rrsC	rrsC
rrsG	rrsG
rrsH	rrsH
rsd	rsd
rseA	rseA
rseB	rseB
rseC	rseC
rseP	rseP
rseX	rseX
rsgA	rsgA
rsmB	rsmB
rsmC	rsmC
rsmD	rsmD
rsmE	rsmE
rsmF	rsmF
rspA	rspA
rspB	rspB
rssA	rssA
rssB	rssB
rstA	rstA
rstB	rstB
rsuA	rsuA
rsxA	rsxA
rsxB	rsxB
rsxC	rsxC
rsxD	rsxD
rsxE	rsxE
rsxG	rsxG
rtcA	rtcA
rtcB	rtcB
rtcR	rtcR
rtn	rtn
rttR	rttR
rumA	rumA
rumB	rumB
rusA	rusA
rutA	rutA
rutB	rutB
rutC	rutC
rutD	rutD
rutE	rutE
rutF	rutF
rutG	rutG
rutR	rutR
ruvA	ruvA
ruvB	ruvB
ruvC	ruvC
rybA	rybA
rybB	rybB
rydB	rydB
rydC	rydC
ryeA	ryeA
ryeB	ryeB
ryeC	ryeC
ryeD	ryeD
ryfA	ryfA
ryfB	ryfB
ryfC	ryfC
ryfD	ryfD
rygC	rygC
rygD	rygD
ryhA	ryhA
ryhB	ryhB
ryjA	ryjA
ryjB	ryjB
rzpD	rzpD
rzpQ	rzpQ
rzpR	rzpR
sad	sad
sanA	sanA
sapA	sapA
sapB	sapB
sapC	sapC
sapD	sapD
sapF	sapF
sbcB	sbcB
sbcC	sbcC
sbcD	sbcD
sbmA	sbmA
sbmC	sbmC
sbp	sbp
scpA	scpA
scpB	scpB
scpC	scpC
sdaA	sdaA
sdaB	sdaB
sdaC	sdaC
sdhA	sdhA
sdhB	sdhB
sdhC	sdhC
sdhD	sdhD
sdiA	sdiA
secA	secA
secB	secB
secD	secD
secE	secE
secF	secF
secG	secG
secM	secM
secY	secY
selA	selA
selB	selB
selC	selC
selD	selD
seqA	seqA
serA	serA
serB	serB
serC	serC
serS	serS
serT	serT
serU	serU
serV	serV
setA	setA
setB	setB
setC	setC
sfmA	sfmA
sfmC	sfmC
sfmD	sfmD
sfmF	sfmF
sfmH	sfmH
sfsA	sfsA
sfsB	sfsB
sgbE	sgbE
sgbH	sgbH
sgbU	sgbU
sgcA	sgcA
sgcB	sgcB
sgcC	sgcC
sgcE	sgcE
sgcQ	sgcQ
sgcR	sgcR
sgcX	sgcX
sgrR	sgrR
sgrS	sgrS
shiA	shiA
sieB	sieB
sirA	sirA
sixA	sixA
skp	skp
slmA	slmA
slp	slp
slt	slt
slyA	slyA
slyB	slyB
slyD	slyD
slyX	slyX
smf	smf
smg	smg
smpA	smpA
smpB	smpB
smtA	smtA
sodA	sodA
sodB	sodB
sodC	sodC
sohA	sohA
sohB	sohB
sokA	sokA
sokB	sokB
solA	solA
soxR	soxR
soxS	soxS
speA	speA
speB	speB
speC	speC
speD	speD
speE	speE
speF	speF
speG	speG
spf	spf
spoT	spoT
sppA	sppA
spr	spr
spy	spy
sra	sra
srlA	srlA
srlB	srlB
srlD	srlD
srlE	srlE
srlR	srlR
srmB	srmB
sroB	sroB
ssb	ssb
sscR	sscR
sseA	sseA
sseB	sseB
ssnA	ssnA
sspA	sspA
sspB	sspB
ssrA	ssrA
ssrS	ssrS
sstT	sstT
ssuA	ssuA
ssuB	ssuB
ssuC	ssuC
ssuD	ssuD
ssuE	ssuE
stfE	stfE
stfR	stfR
sthA	sthA
stpA	stpA
sucA	sucA
sucB	sucB
sucC	sucC
sucD	sucD
sufA	sufA
sufB	sufB
sufC	sufC
sufD	sufD
sufE	sufE
sufS	sufS
sugE	sugE
suhB	suhB
sulA	sulA
surA	surA
surE	surE
sxy	sxy
syd	syd
symE	symE
symR	symR
tadA	tadA
tag	tag
talA	talA
talB	talB
tam	tam
tap	tap
tar	tar
tas	tas
tatA	tatA
tatB	tatB
tatC	tatC
tatD	tatD
tatE	tatE
tauA	tauA
tauB	tauB
tauC	tauC
tauD	tauD
tbpA	tbpA
tdcA	tdcA
tdcB	tdcB
tdcC	tdcC
tdcD	tdcD
tdcE	tdcE
tdcF	tdcF
tdcG	tdcG
tdcR	tdcR
tdh	tdh
tdk	tdk
tehA	tehA
tehB	tehB
tesA	tesA
tesB	tesB
tfaD	tfaD
tfaE	tfaE
tfaS	tfaS
tfaX	tfaX
tff	tff
tgt	tgt
thiC	thiC
thiD	thiD
thiE	thiE
thiF	thiF
thiG	thiG
thiH	thiH
thiI	thiI
thiK	thiK
thiL	thiL
thiM	thiM
thiP	thiP
thiQ	thiQ
thiS	thiS
thrA	thrA
thrB	thrB
thrC	thrC
thrL	thrL
thrS	thrS
thrT	thrT
thrU	thrU
thrV	thrV
thrW	thrW
thyA	thyA
tig	tig
tilS	tilS
tisB	tisB
tktA	tktA
tktB	tktB
tldD	tldD
tmk	tmk
tnaA	tnaA
tnaB	tnaB
tnaC	tnaC
tolA	tolA
tolB	tolB
tolC	tolC
tolQ	tolQ
tolR	tolR
tomB	tomB
tonB	tonB
topA	topA
topB	topB
torA	torA
torC	torC
torD	torD
torI	torI
torR	torR
torS	torS
torT	torT
torY	torY
torZ	torZ
tpiA	tpiA
tppB	tppB
tpx	tpx
tqsA	tqsA
treA	treA
treB	treB
treC	treC
treF	treF
treR	treR
trg	trg
trkA	trkA
trkG	trkG
trkH	trkH
trmA	trmA
trmD	trmD
trmH	trmH
trmI	trmI
trmJ	trmJ
trpA	trpA
trpB	trpB
trpC	trpC
trpD	trpD
trpE	trpE
trpL	trpL
trpR	trpR
trpS	trpS
trpT	trpT
truA	truA
truB	truB
truC	truC
truD	truD
trxA	trxA
trxB	trxB
trxC	trxC
tsf	tsf
tsgA	tsgA
tsr	tsr
tsx	tsx
ttcA	ttcA
ttcC	ttcC
ttdA	ttdA
ttdB	ttdB
ttdR	ttdR
ttdT	ttdT
tus	tus
tynA	tynA
typA	typA
tyrA	tyrA
tyrB	tyrB
tyrP	tyrP
tyrR	tyrR
tyrS	tyrS
tyrU	tyrU
ubiA	ubiA
ubiB	ubiB
ubiC	ubiC
ubiD	ubiD
ubiE	ubiE
ubiF	ubiF
ubiG	ubiG
ubiH	ubiH
ubiX	ubiX
ucpA	ucpA
udk	udk
udp	udp
ugd	ugd
ugpA	ugpA
ugpB	ugpB
ugpC	ugpC
ugpE	ugpE
ugpQ	ugpQ
uhpA	uhpA
uhpB	uhpB
uhpC	uhpC
uhpT	uhpT
uidA	uidA
uidB	uidB
uidC	uidC
uidR	uidR
ulaA	ulaA
ulaB	ulaB
ulaC	ulaC
ulaD	ulaD
ulaE	ulaE
ulaF	ulaF
ulaG	ulaG
ulaR	ulaR
umuC	umuC
umuD	umuD
ung	ung
uof	uof
upp	upp
uraA	uraA
usg	usg
ushA	ushA
uspA	uspA
uspB	uspB
uspC	uspC
uspD	uspD
uspE	uspE
uspF	uspF
uspG	uspG
uup	uup
uvrA	uvrA
uvrB	uvrB
uvrC	uvrC
uvrD	uvrD
uvrY	uvrY
uxaA	uxaA
uxaB	uxaB
uxaC	uxaC
uxuA	uxuA
uxuB	uxuB
uxuR	uxuR
vacJ	vacJ
valS	valS
valV	valV
valW	valW
ves	ves
viaA	viaA
visC	visC
vsr	vsr
waaA	waaA
waaU	waaU
wbbI	wbbI
wbbJ	wbbJ
wbbK	wbbK
wbbL	wbbL
wcaA	wcaA
wcaB	wcaB
wcaC	wcaC
wcaD	wcaD
wcaE	wcaE
wcaF	wcaF
wcaI	wcaI
wcaJ	wcaJ
wcaK	wcaK
wcaL	wcaL
wcaM	wcaM
wecH	wecH
wrbA	wrbA
wza	wza
wzb	wzb
wzc	wzc
wzxC	wzxC
wzxE	wzxE
wzyE	wzyE
wzzE	wzzE
xapA	xapA
xapB	xapB
xapR	xapR
xdhA	xdhA
xdhB	xdhB
xdhC	xdhC
xdhD	xdhD
xerC	xerC
xerD	xerD
xisE	xisE
xseA	xseA
xseB	xseB
xthA	xthA
xylA	xylA
xylB	xylB
xylE	xylE
xylF	xylF
xylG	xylG
xylH	xylH
xylR	xylR
yaaA	yaaA
yaaH	yaaH
yaaI	yaaI
yaaJ	yaaJ
yaaU	yaaU
yaaW	yaaW
yaaX	yaaX
yaaY	yaaY
yabI	yabI
yabP	yabP
yacC	yacC
yacF	yacF
yacG	yacG
yacH	yacH
yacL	yacL
yadB	yadB
yadC	yadC
yadD	yadD
yadE	yadE
yadG	yadG
yadH	yadH
yadI	yadI
yadK	yadK
yadL	yadL
yadM	yadM
yadN	yadN
yadS	yadS
yaeB	yaeB
yaeF	yaeF
yaeH	yaeH
yaeI	yaeI
yaeJ	yaeJ
yaeP	yaeP
yaeQ	yaeQ
yaeR	yaeR
yafC	yafC
yafD	yafD
yafE	yafE
yafJ	yafJ
yafK	yafK
yafL	yafL
yafM	yafM
yafN	yafN
yafO	yafO
yafP	yafP
yafQ	yafQ
yafS	yafS
yafT	yafT
yafU	yafU
yafV	yafV
yafW	yafW
yafX	yafX
yafY	yafY
yafZ	yafZ
yagA	yagA
yagB	yagB
yagE	yagE
yagF	yagF
yagG	yagG
yagH	yagH
yagI	yagI
yagJ	yagJ
yagK	yagK
yagL	yagL
yagM	yagM
yagN	yagN
yagP	yagP
yagQ	yagQ
yagR	yagR
yagS	yagS
yagT	yagT
yagU	yagU
yagV	yagV
yagW	yagW
yagX	yagX
yahA	yahA
yahB	yahB
yahC	yahC
yahD	yahD
yahE	yahE
yahF	yahF
yahG	yahG
yahI	yahI
yahJ	yahJ
yahK	yahK
yahL	yahL
yahM	yahM
yahN	yahN
yahO	yahO
yaiA	yaiA
yaiE	yaiE
yaiI	yaiI
yaiL	yaiL
yaiO	yaiO
yaiP	yaiP
yaiS	yaiS
yaiT	yaiT
yaiV	yaiV
yaiW	yaiW
yaiX	yaiX
yaiY	yaiY
yaiZ	yaiZ
yajC	yajC
yajD	yajD
yajG	yajG
yajI	yajI
yajL	yajL
yajO	yajO
yajQ	yajQ
yajR	yajR
ybaA	ybaA
ybaB	ybaB
ybaE	ybaE
ybaK	ybaK
ybaL	ybaL
ybaM	ybaM
ybaN	ybaN
ybaO	ybaO
ybaP	ybaP
ybaQ	ybaQ
ybaS	ybaS
ybaT	ybaT
ybaV	ybaV
ybaW	ybaW
ybaY	ybaY
ybaZ	ybaZ
ybbA	ybbA
ybbB	ybbB
ybbC	ybbC
ybbD	ybbD
ybbJ	ybbJ
ybbL	ybbL
ybbM	ybbM
ybbN	ybbN
ybbO	ybbO
ybbP	ybbP
ybbW	ybbW
ybbY	ybbY
ybcF	ybcF
ybcH	ybcH
ybcI	ybcI
ybcJ	ybcJ
ybcK	ybcK
ybcL	ybcL
ybcM	ybcM
ybcN	ybcN
ybcO	ybcO
ybcV	ybcV
ybcW	ybcW
ybcY	ybcY
ybdB	ybdB
ybdD	ybdD
ybdF	ybdF
ybdG	ybdG
ybdH	ybdH
ybdJ	ybdJ
ybdK	ybdK
ybdL	ybdL
ybdM	ybdM
ybdN	ybdN
ybdO	ybdO
ybdR	ybdR
ybdZ	ybdZ
ybeA	ybeA
ybeB	ybeB
ybeD	ybeD
ybeF	ybeF
ybeL	ybeL
ybeM	ybeM
ybeQ	ybeQ
ybeR	ybeR
ybeT	ybeT
ybeU	ybeU
ybeX	ybeX
ybeY	ybeY
ybeZ	ybeZ
ybfA	ybfA
ybfB	ybfB
ybfC	ybfC
ybfE	ybfE
ybfF	ybfF
ybfG	ybfG
ybfI	ybfI
ybfK	ybfK
ybfL	ybfL
ybfM	ybfM
ybfN	ybfN
ybfO	ybfO
ybfP	ybfP
ybfQ	ybfQ
ybgA	ybgA
ybgC	ybgC
ybgD	ybgD
ybgE	ybgE
ybgF	ybgF
ybgH	ybgH
ybgI	ybgI
ybgJ	ybgJ
ybgK	ybgK
ybgL	ybgL
ybgO	ybgO
ybgP	ybgP
ybgQ	ybgQ
ybgS	ybgS
ybgT	ybgT
ybhA	ybhA
ybhB	ybhB
ybhC	ybhC
ybhD	ybhD
ybhF	ybhF
ybhG	ybhG
ybhH	ybhH
ybhI	ybhI
ybhJ	ybhJ
ybhK	ybhK
ybhL	ybhL
ybhM	ybhM
ybhN	ybhN
ybhO	ybhO
ybhP	ybhP
ybhQ	ybhQ
ybhR	ybhR
ybhS	ybhS
ybhT	ybhT
ybhU	ybhU
ybiA	ybiA
ybiB	ybiB
ybiC	ybiC
ybiH	ybiH
ybiI	ybiI
ybiJ	ybiJ
ybiO	ybiO
ybiP	ybiP
ybiR	ybiR
ybiS	ybiS
ybiT	ybiT
ybiU	ybiU
ybiV	ybiV
ybiW	ybiW
ybiX	ybiX
ybiY	ybiY
ybjC	ybjC
ybjD	ybjD
ybjE	ybjE
ybjG	ybjG
ybjH	ybjH
ybjI	ybjI
ybjJ	ybjJ
ybjK	ybjK
ybjL	ybjL
ybjM	ybjM
ybjN	ybjN
ybjO	ybjO
ybjP	ybjP
ybjQ	ybjQ
ybjS	ybjS
ybjT	ybjT
ybjX	ybjX
ycaC	ycaC
ycaD	ycaD
ycaI	ycaI
ycaK	ycaK
ycaL	ycaL
ycaM	ycaM
ycaN	ycaN
ycaO	ycaO
ycaP	ycaP
ycaQ	ycaQ
ycaR	ycaR
ycbB	ycbB
ycbC	ycbC
ycbF	ycbF
ycbG	ycbG
ycbJ	ycbJ
ycbK	ycbK
ycbL	ycbL
ycbQ	ycbQ
ycbR	ycbR
ycbS	ycbS
ycbT	ycbT
ycbU	ycbU
ycbV	ycbV
ycbW	ycbW
ycbX	ycbX
ycbZ	ycbZ
yccA	yccA
yccB	yccB
yccE	yccE
yccF	yccF
yccJ	yccJ
yccK	yccK
yccM	yccM
yccS	yccS
yccT	yccT
yccU	yccU
yccW	yccW
yccX	yccX
ycdT	ycdT
ycdU	ycdU
ycdX	ycdX
ycdY	ycdY
ycdZ	ycdZ
yceA	yceA
yceB	yceB
yceD	yceD
yceF	yceF
yceG	yceG
yceH	yceH
yceI	yceI
yceJ	yceJ
yceK	yceK
yceM	yceM
yceN	yceN
yceO	yceO
yceQ	yceQ
ycfD	ycfD
ycfH	ycfH
ycfJ	ycfJ
ycfK	ycfK
ycfL	ycfL
ycfM	ycfM
ycfP	ycfP
ycfQ	ycfQ
ycfS	ycfS
ycfT	ycfT
ycfZ	ycfZ
ycgB	ycgB
ycgE	ycgE
ycgF	ycgF
ycgG	ycgG
ycgH	ycgH
ycgI	ycgI
ycgJ	ycgJ
ycgK	ycgK
ycgL	ycgL
ycgM	ycgM
ycgN	ycgN
ycgR	ycgR
ycgV	ycgV
ycgX	ycgX
ycgY	ycgY
ycgZ	ycgZ
ychA	ychA
ychE	ychE
ychF	ychF
ychH	ychH
ychJ	ychJ
ychM	ychM
ychN	ychN
ychO	ychO
ychQ	ychQ
ychS	ychS
yciA	yciA
yciB	yciB
yciC	yciC
yciE	yciE
yciF	yciF
yciG	yciG
yciH	yciH
yciI	yciI
yciK	yciK
yciM	yciM
yciN	yciN
yciO	yciO
yciQ	yciQ
yciS	yciS
yciT	yciT
yciU	yciU
yciV	yciV
yciW	yciW
yciX	yciX
yciY	yciY
yciZ	yciZ
ycjD	ycjD
ycjF	ycjF
ycjG	ycjG
ycjM	ycjM
ycjN	ycjN
ycjO	ycjO
ycjP	ycjP
ycjQ	ycjQ
ycjR	ycjR
ycjS	ycjS
ycjT	ycjT
ycjU	ycjU
ycjV	ycjV
ycjW	ycjW
ycjX	ycjX
ycjY	ycjY
ycjZ	ycjZ
ydaC	ydaC
ydaE	ydaE
ydaG	ydaG
ydaL	ydaL
ydaM	ydaM
ydaN	ydaN
ydaQ	ydaQ
ydaS	ydaS
ydaT	ydaT
ydaU	ydaU
ydaV	ydaV
ydaW	ydaW
ydaY	ydaY
ydbA	ydbA
ydbC	ydbC
ydbD	ydbD
ydbH	ydbH
ydbJ	ydbJ
ydbK	ydbK
ydbL	ydbL
ydcA	ydcA
ydcD	ydcD
ydcF	ydcF
ydcH	ydcH
ydcI	ydcI
ydcJ	ydcJ
ydcK	ydcK
ydcL	ydcL
ydcM	ydcM
ydcN	ydcN
ydcO	ydcO
ydcP	ydcP
ydcQ	ydcQ
ydcR	ydcR
ydcS	ydcS
ydcT	ydcT
ydcU	ydcU
ydcV	ydcV
ydcW	ydcW
ydcX	ydcX
ydcY	ydcY
ydcZ	ydcZ
yddA	yddA
yddB	yddB
yddE	yddE
yddG	yddG
yddH	yddH
yddJ	yddJ
yddK	yddK
yddL	yddL
yddM	yddM
yddV	yddV
yddW	yddW
ydeA	ydeA
ydeE	ydeE
ydeH	ydeH
ydeI	ydeI
ydeJ	ydeJ
ydeK	ydeK
ydeM	ydeM
ydeN	ydeN
ydeO	ydeO
ydeP	ydeP
ydeQ	ydeQ
ydeR	ydeR
ydeS	ydeS
ydeT	ydeT
ydeU	ydeU
ydfA	ydfA
ydfB	ydfB
ydfD	ydfD
ydfE	ydfE
ydfG	ydfG
ydfH	ydfH
ydfI	ydfI
ydfJ	ydfJ
ydfN	ydfN
ydfO	ydfO
ydfP	ydfP
ydfR	ydfR
ydfU	ydfU
ydfV	ydfV
ydfW	ydfW
ydfX	ydfX
ydfZ	ydfZ
ydgA	ydgA
ydgC	ydgC
ydgD	ydgD
ydgH	ydgH
ydgI	ydgI
ydgJ	ydgJ
ydgK	ydgK
ydgU	ydgU
ydhA	ydhA
ydhB	ydhB
ydhC	ydhC
ydhF	ydhF
ydhI	ydhI
ydhJ	ydhJ
ydhK	ydhK
ydhL	ydhL
ydhO	ydhO
ydhP	ydhP
ydhQ	ydhQ
ydhR	ydhR
ydhS	ydhS
ydhT	ydhT
ydhU	ydhU
ydhV	ydhV
ydhW	ydhW
ydhX	ydhX
ydhY	ydhY
ydhZ	ydhZ
ydiA	ydiA
ydiB	ydiB
ydiE	ydiE
ydiF	ydiF
ydiH	ydiH
ydiI	ydiI
ydiJ	ydiJ
ydiK	ydiK
ydiL	ydiL
ydiM	ydiM
ydiN	ydiN
ydiO	ydiO
ydiP	ydiP
ydiQ	ydiQ
ydiR	ydiR
ydiS	ydiS
ydiT	ydiT
ydiU	ydiU
ydiV	ydiV
ydiY	ydiY
ydiZ	ydiZ
ydjA	ydjA
ydjE	ydjE
ydjF	ydjF
ydjG	ydjG
ydjH	ydjH
ydjI	ydjI
ydjJ	ydjJ
ydjK	ydjK
ydjL	ydjL
ydjM	ydjM
ydjN	ydjN
ydjO	ydjO
ydjX	ydjX
ydjY	ydjY
ydjZ	ydjZ
yeaC	yeaC
yeaD	yeaD
yeaE	yeaE
yeaG	yeaG
yeaH	yeaH
yeaI	yeaI
yeaJ	yeaJ
yeaK	yeaK
yeaL	yeaL
yeaM	yeaM
yeaN	yeaN
yeaO	yeaO
yeaP	yeaP
yeaQ	yeaQ
yeaR	yeaR
yeaT	yeaT
yeaU	yeaU
yeaV	yeaV
yeaW	yeaW
yeaX	yeaX
yeaY	yeaY
yeaZ	yeaZ
yebA	yebA
yebB	yebB
yebC	yebC
yebE	yebE
yebF	yebF
yebG	yebG
yebK	yebK
yebN	yebN
yebO	yebO
yebQ	yebQ
yebR	yebR
yebS	yebS
yebT	yebT
yebV	yebV
yebW	yebW
yebY	yebY
yebZ	yebZ
yecA	yecA
yecC	yecC
yecD	yecD
yecE	yecE
yecF	yecF
yecH	yecH
yecM	yecM
yecN	yecN
yecR	yecR
yecS	yecS
yecT	yecT
yedA	yedA
yedD	yedD
yedE	yedE
yedF	yedF
yedI	yedI
yedJ	yedJ
yedK	yedK
yedL	yedL
yedN	yedN
yedP	yedP
yedQ	yedQ
yedR	yedR
yedS	yedS
yedV	yedV
yedW	yedW
yedX	yedX
yedY	yedY
yedZ	yedZ
yeeA	yeeA
yeeD	yeeD
yeeE	yeeE
yeeF	yeeF
yeeH	yeeH
yeeJ	yeeJ
yeeL	yeeL
yeeN	yeeN
yeeO	yeeO
yeeP	yeeP
yeeR	yeeR
yeeS	yeeS
yeeT	yeeT
yeeU	yeeU
yeeV	yeeV
yeeW	yeeW
yeeX	yeeX
yeeY	yeeY
yeeZ	yeeZ
yefM	yefM
yegD	yegD
yegE	yegE
yegH	yegH
yegI	yegI
yegJ	yegJ
yegK	yegK
yegL	yegL
yegP	yegP
yegQ	yegQ
yegR	yegR
yegS	yegS
yegT	yegT
yegU	yegU
yegV	yegV
yegW	yegW
yegX	yegX
yegZ	yegZ
yehA	yehA
yehB	yehB
yehC	yehC
yehD	yehD
yehE	yehE
yehH	yehH
yehI	yehI
yehK	yehK
yehL	yehL
yehM	yehM
yehP	yehP
yehQ	yehQ
yehR	yehR
yehS	yehS
yehT	yehT
yehU	yehU
yehW	yehW
yehX	yehX
yehY	yehY
yeiA	yeiA
yeiB	yeiB
yeiE	yeiE
yeiG	yeiG
yeiH	yeiH
yeiI	yeiI
yeiL	yeiL
yeiP	yeiP
yeiQ	yeiQ
yeiR	yeiR
yeiS	yeiS
yeiT	yeiT
yeiW	yeiW
yejA	yejA
yejB	yejB
yejE	yejE
yejF	yejF
yejG	yejG
yejH	yejH
yejK	yejK
yejL	yejL
yejM	yejM
yejO	yejO
yfaA	yfaA
yfaD	yfaD
yfaE	yfaE
yfaH	yfaH
yfaL	yfaL
yfaP	yfaP
yfaQ	yfaQ
yfaS	yfaS
yfaT	yfaT
yfaU	yfaU
yfaV	yfaV
yfaW	yfaW
yfaX	yfaX
yfaY	yfaY
yfaZ	yfaZ
yfbB	yfbB
yfbK	yfbK
yfbL	yfbL
yfbM	yfbM
yfbN	yfbN
yfbO	yfbO
yfbP	yfbP
yfbQ	yfbQ
yfbR	yfbR
yfbS	yfbS
yfbT	yfbT
yfbU	yfbU
yfbV	yfbV
yfcA	yfcA
yfcC	yfcC
yfcD	yfcD
yfcE	yfcE
yfcF	yfcF
yfcG	yfcG
yfcH	yfcH
yfcI	yfcI
yfcJ	yfcJ
yfcL	yfcL
yfcM	yfcM
yfcN	yfcN
yfcO	yfcO
yfcP	yfcP
yfcQ	yfcQ
yfcR	yfcR
yfcS	yfcS
yfcU	yfcU
yfcV	yfcV
yfcZ	yfcZ
yfdC	yfdC
yfdE	yfdE
yfdF	yfdF
yfdG	yfdG
yfdH	yfdH
yfdI	yfdI
yfdK	yfdK
yfdL	yfdL
yfdM	yfdM
yfdN	yfdN
yfdO	yfdO
yfdP	yfdP
yfdQ	yfdQ
yfdR	yfdR
yfdS	yfdS
yfdT	yfdT
yfdV	yfdV
yfdX	yfdX
yfdY	yfdY
yfdZ	yfdZ
yfeA	yfeA
yfeC	yfeC
yfeD	yfeD
yfeH	yfeH
yfeK	yfeK
yfeN	yfeN
yfeO	yfeO
yfeR	yfeR
yfeS	yfeS
yfeT	yfeT
yfeW	yfeW
yfeX	yfeX
yfeY	yfeY
yfeZ	yfeZ
yffB	yffB
yffL	yffL
yffM	yffM
yffN	yffN
yffO	yffO
yffP	yffP
yffQ	yffQ
yffR	yffR
yffS	yffS
yfgA	yfgA
yfgC	yfgC
yfgD	yfgD
yfgF	yfgF
yfgG	yfgG
yfgH	yfgH
yfgI	yfgI
yfgJ	yfgJ
yfgM	yfgM
yfgO	yfgO
yfhA	yfhA
yfhB	yfhB
yfhG	yfhG
yfhH	yfhH
yfhK	yfhK
yfhL	yfhL
yfhM	yfhM
yfhR	yfhR
yfiB	yfiB
yfiC	yfiC
yfiD	yfiD
yfiE	yfiE
yfiF	yfiF
yfiH	yfiH
yfiL	yfiL
yfiM	yfiM
yfiN	yfiN
yfiP	yfiP
yfiQ	yfiQ
yfiR	yfiR
yfjD	yfjD
yfjF	yfjF
yfjG	yfjG
yfjH	yfjH
yfjI	yfjI
yfjJ	yfjJ
yfjK	yfjK
yfjL	yfjL
yfjM	yfjM
yfjO	yfjO
yfjP	yfjP
yfjQ	yfjQ
yfjR	yfjR
yfjS	yfjS
yfjT	yfjT
yfjU	yfjU
yfjV	yfjV
yfjW	yfjW
yfjX	yfjX
yfjY	yfjY
yfjZ	yfjZ
ygaC	ygaC
ygaD	ygaD
ygaF	ygaF
ygaH	ygaH
ygaM	ygaM
ygaP	ygaP
ygaQ	ygaQ
ygaU	ygaU
ygaV	ygaV
ygaW	ygaW
ygaY	ygaY
ygaZ	ygaZ
ygbA	ygbA
ygbE	ygbE
ygbF	ygbF
ygbI	ygbI
ygbJ	ygbJ
ygbK	ygbK
ygbL	ygbL
ygbM	ygbM
ygbN	ygbN
ygbT	ygbT
ygcB	ygcB
ygcE	ygcE
ygcF	ygcF
ygcG	ygcG
ygcH	ygcH
ygcI	ygcI
ygcJ	ygcJ
ygcK	ygcK
ygcL	ygcL
ygcN	ygcN
ygcO	ygcO
ygcP	ygcP
ygcQ	ygcQ
ygcR	ygcR
ygcS	ygcS
ygcU	ygcU
ygcW	ygcW
ygdB	ygdB
ygdD	ygdD
ygdE	ygdE
ygdG	ygdG
ygdH	ygdH
ygdI	ygdI
ygdL	ygdL
ygdQ	ygdQ
ygdR	ygdR
ygdT	ygdT
ygeA	ygeA
ygeF	ygeF
ygeG	ygeG
ygeH	ygeH
ygeI	ygeI
ygeK	ygeK
ygeN	ygeN
ygeO	ygeO
ygeQ	ygeQ
ygeR	ygeR
ygeV	ygeV
ygeW	ygeW
ygeX	ygeX
ygeY	ygeY
ygfA	ygfA
ygfB	ygfB
ygfF	ygfF
ygfI	ygfI
ygfJ	ygfJ
ygfK	ygfK
ygfM	ygfM
ygfO	ygfO
ygfQ	ygfQ
ygfS	ygfS
ygfT	ygfT
ygfU	ygfU
ygfX	ygfX
ygfY	ygfY
ygfZ	ygfZ
yggC	yggC
yggD	yggD
yggE	yggE
yggF	yggF
yggG	yggG
yggI	yggI
yggL	yggL
yggM	yggM
yggN	yggN
yggP	yggP
yggR	yggR
yggS	yggS
yggT	yggT
yggU	yggU
yggW	yggW
yggX	yggX
yghA	yghA
yghB	yghB
yghD	yghD
yghE	yghE
yghF	yghF
yghG	yghG
yghJ	yghJ
yghO	yghO
yghQ	yghQ
yghR	yghR
yghS	yghS
yghT	yghT
yghU	yghU
yghW	yghW
yghX	yghX
yghZ	yghZ
ygiB	ygiB
ygiC	ygiC
ygiD	ygiD
ygiF	ygiF
ygiH	ygiH
ygiL	ygiL
ygiN	ygiN
ygiQ	ygiQ
ygiS	ygiS
ygiT	ygiT
ygiV	ygiV
ygiW	ygiW
ygiZ	ygiZ
ygjD	ygjD
ygjG	ygjG
ygjH	ygjH
ygjI	ygjI
ygjJ	ygjJ
ygjK	ygjK
ygjM	ygjM
ygjN	ygjN
ygjP	ygjP
ygjQ	ygjQ
ygjR	ygjR
ygjV	ygjV
yhaB	yhaB
yhaC	yhaC
yhaH	yhaH
yhaI	yhaI
yhaJ	yhaJ
yhaK	yhaK
yhaL	yhaL
yhaM	yhaM
yhaO	yhaO
yhaV	yhaV
yhbC	yhbC
yhbE	yhbE
yhbJ	yhbJ
yhbO	yhbO
yhbP	yhbP
yhbQ	yhbQ
yhbS	yhbS
yhbT	yhbT
yhbU	yhbU
yhbV	yhbV
yhbW	yhbW
yhbX	yhbX
yhbY	yhbY
yhcA	yhcA
yhcB	yhcB
yhcC	yhcC
yhcD	yhcD
yhcE	yhcE
yhcF	yhcF
yhcG	yhcG
yhcH	yhcH
yhcM	yhcM
yhcN	yhcN
yhcO	yhcO
yhdE	yhdE
yhdH	yhdH
yhdJ	yhdJ
yhdL	yhdL
yhdN	yhdN
yhdP	yhdP
yhdT	yhdT
yhdU	yhdU
yhdV	yhdV
yhdW	yhdW
yhdX	yhdX
yhdY	yhdY
yhdZ	yhdZ
yheL	yheL
yheM	yheM
yheN	yheN
yheO	yheO
yheS	yheS
yheT	yheT
yheU	yheU
yheV	yheV
yhfA	yhfA
yhfG	yhfG
yhfK	yhfK
yhfL	yhfL
yhfS	yhfS
yhfT	yhfT
yhfU	yhfU
yhfW	yhfW
yhfX	yhfX
yhfY	yhfY
yhfZ	yhfZ
yhgA	yhgA
yhgE	yhgE
yhgF	yhgF
yhgN	yhgN
yhhA	yhhA
yhhH	yhhH
yhhJ	yhhJ
yhhK	yhhK
yhhL	yhhL
yhhM	yhhM
yhhN	yhhN
yhhQ	yhhQ
yhhS	yhhS
yhhT	yhhT
yhhW	yhhW
yhhX	yhhX
yhhY	yhhY
yhhZ	yhhZ
yhiD	yhiD
yhiI	yhiI
yhiJ	yhiJ
yhiL	yhiL
yhiM	yhiM
yhiN	yhiN
yhiQ	yhiQ
yhiR	yhiR
yhiS	yhiS
yhjA	yhjA
yhjB	yhjB
yhjC	yhjC
yhjD	yhjD
yhjE	yhjE
yhjG	yhjG
yhjH	yhjH
yhjJ	yhjJ
yhjK	yhjK
yhjQ	yhjQ
yhjR	yhjR
yhjV	yhjV
yhjX	yhjX
yhjY	yhjY
yiaA	yiaA
yiaB	yiaB
yiaC	yiaC
yiaD	yiaD
yiaF	yiaF
yiaG	yiaG
yiaJ	yiaJ
yiaK	yiaK
yiaL	yiaL
yiaM	yiaM
yiaN	yiaN
yiaO	yiaO
yiaT	yiaT
yiaU	yiaU
yiaV	yiaV
yiaW	yiaW
yiaY	yiaY
yibA	yibA
yibD	yibD
yibF	yibF
yibG	yibG
yibH	yibH
yibI	yibI
yibJ	yibJ
yibK	yibK
yibL	yibL
yibN	yibN
yibQ	yibQ
yibT	yibT
yibU	yibU
yibV	yibV
yicC	yicC
yicE	yicE
yicG	yicG
yicH	yicH
yicI	yicI
yicJ	yicJ
yicL	yicL
yicN	yicN
yicO	yicO
yicR	yicR
yicS	yicS
yicT	yicT
yidA	yidA
yidB	yidB
yidC	yidC
yidD	yidD
yidE	yidE
yidF	yidF
yidG	yidG
yidH	yidH
yidI	yidI
yidJ	yidJ
yidK	yidK
yidL	yidL
yidP	yidP
yidQ	yidQ
yidR	yidR
yidX	yidX
yidZ	yidZ
yieE	yieE
yieF	yieF
yieG	yieG
yieH	yieH
yieK	yieK
yieL	yieL
yieP	yieP
yifB	yifB
yifE	yifE
yifK	yifK
yifL	yifL
yifN	yifN
yigA	yigA
yigB	yigB
yigE	yigE
yigF	yigF
yigG	yigG
yigI	yigI
yigL	yigL
yigM	yigM
yigP	yigP
yigZ	yigZ
yihA	yihA
yihD	yihD
yihF	yihF
yihG	yihG
yihI	yihI
yihL	yihL
yihM	yihM
yihN	yihN
yihO	yihO
yihP	yihP
yihQ	yihQ
yihR	yihR
yihS	yihS
yihT	yihT
yihU	yihU
yihV	yihV
yihW	yihW
yihX	yihX
yihY	yihY
yiiD	yiiD
yiiE	yiiE
yiiF	yiiF
yiiG	yiiG
yiiM	yiiM
yiiQ	yiiQ
yiiR	yiiR
yiiS	yiiS
yiiU	yiiU
yiiX	yiiX
yijD	yijD
yijE	yijE
yijF	yijF
yijO	yijO
yijP	yijP
yjaA	yjaA
yjaB	yjaB
yjaG	yjaG
yjaH	yjaH
yjaZ	yjaZ
yjbB	yjbB
yjbE	yjbE
yjbF	yjbF
yjbG	yjbG
yjbH	yjbH
yjbI	yjbI
yjbJ	yjbJ
yjbL	yjbL
yjbM	yjbM
yjbQ	yjbQ
yjbR	yjbR
yjbS	yjbS
yjbT	yjbT
yjcB	yjcB
yjcC	yjcC
yjcD	yjcD
yjcE	yjcE
yjcF	yjcF
yjcH	yjcH
yjcO	yjcO
yjcS	yjcS
yjcZ	yjcZ
yjdA	yjdA
yjdC	yjdC
yjdF	yjdF
yjdI	yjdI
yjdJ	yjdJ
yjdK	yjdK
yjdL	yjdL
yjdM	yjdM
yjdN	yjdN
yjdO	yjdO
yjdQ	yjdQ
yjeE	yjeE
yjeF	yjeF
yjeH	yjeH
yjeI	yjeI
yjeJ	yjeJ
yjeK	yjeK
yjeM	yjeM
yjeN	yjeN
yjeO	yjeO
yjeP	yjeP
yjeS	yjeS
yjeT	yjeT
yjfC	yjfC
yjfF	yjfF
yjfI	yjfI
yjfJ	yjfJ
yjfK	yjfK
yjfL	yjfL
yjfM	yjfM
yjfN	yjfN
yjfO	yjfO
yjfP	yjfP
yjfY	yjfY
yjfZ	yjfZ
yjgA	yjgA
yjgB	yjgB
yjgF	yjgF
yjgH	yjgH
yjgI	yjgI
yjgJ	yjgJ
yjgK	yjgK
yjgL	yjgL
yjgM	yjgM
yjgN	yjgN
yjgP	yjgP
yjgQ	yjgQ
yjgR	yjgR
yjgX	yjgX
yjgZ	yjgZ
yjhB	yjhB
yjhC	yjhC
yjhD	yjhD
yjhE	yjhE
yjhF	yjhF
yjhG	yjhG
yjhH	yjhH
yjhI	yjhI
yjhP	yjhP
yjhQ	yjhQ
yjhR	yjhR
yjhS	yjhS
yjhU	yjhU
yjhV	yjhV
yjhX	yjhX
yjhY	yjhY
yjiA	yjiA
yjiC	yjiC
yjiD	yjiD
yjiE	yjiE
yjiG	yjiG
yjiH	yjiH
yjiJ	yjiJ
yjiK	yjiK
yjiL	yjiL
yjiM	yjiM
yjiN	yjiN
yjiP	yjiP
yjiR	yjiR
yjiS	yjiS
yjiT	yjiT
yjiV	yjiV
yjiX	yjiX
yjiY	yjiY
yjjA	yjjA
yjjB	yjjB
yjjG	yjjG
yjjI	yjjI
yjjJ	yjjJ
yjjK	yjjK
yjjL	yjjL
yjjM	yjjM
yjjN	yjjN
yjjP	yjjP
yjjQ	yjjQ
yjjU	yjjU
yjjV	yjjV
yjjW	yjjW
yjjX	yjjX
yjjY	yjjY
yjjZ	yjjZ
yjtD	yjtD
ykfA	ykfA
ykfB	ykfB
ykfC	ykfC
ykfF	ykfF
ykfG	ykfG
ykfH	ykfH
ykfI	ykfI
ykfJ	ykfJ
ykfK	ykfK
ykfM	ykfM
ykfN	ykfN
ykgA	ykgA
ykgB	ykgB
ykgC	ykgC
ykgD	ykgD
ykgE	ykgE
ykgF	ykgF
ykgG	ykgG
ykgH	ykgH
ykgI	ykgI
ykgJ	ykgJ
ykgL	ykgL
ykgM	ykgM
ykgO	ykgO
ykgQ	ykgQ
ykiA	ykiA
ylaB	ylaB
ylaC	ylaC
ylbA	ylbA
ylbE	ylbE
ylbF	ylbF
ylbG	ylbG
ylbH	ylbH
ylbI	ylbI
ylcG	ylcG
ylcH	ylcH
ylcI	ylcI
yliE	yliE
yliF	yliF
yliG	yliG
yliI	yliI
yliJ	yliJ
yliL	yliL
ymbA	ymbA
ymcE	ymcE
ymdA	ymdA
ymdB	ymdB
ymdC	ymdC
ymdE	ymdE
ymdF	ymdF
ymfA	ymfA
ymfD	ymfD
ymfE	ymfE
ymfI	ymfI
ymfJ	ymfJ
ymfK	ymfK
ymfL	ymfL
ymfM	ymfM
ymfN	ymfN
ymfO	ymfO
ymfP	ymfP
ymfQ	ymfQ
ymfR	ymfR
ymfS	ymfS
ymfT	ymfT
ymgA	ymgA
ymgC	ymgC
ymgD	ymgD
ymgE	ymgE
ymgF	ymgF
ymgG	ymgG
ymgI	ymgI
ymgJ	ymgJ
ymjA	ymjA
ymjC	ymjC
ynaA	ynaA
ynaI	ynaI
ynaJ	ynaJ
ynaK	ynaK
ynbA	ynbA
ynbB	ynbB
ynbC	ynbC
ynbD	ynbD
ynbE	ynbE
yncA	yncA
yncB	yncB
yncD	yncD
yncE	yncE
yncG	yncG
yncH	yncH
yncI	yncI
yncJ	yncJ
yncK	yncK
yncL	yncL
yncN	yncN
yneE	yneE
yneF	yneF
yneG	yneG
yneH	yneH
yneJ	yneJ
yneK	yneK
yneL	yneL
yneM	yneM
yneN	yneN
ynfA	ynfA
ynfB	ynfB
ynfC	ynfC
ynfD	ynfD
ynfE	ynfE
ynfF	ynfF
ynfG	ynfG
ynfH	ynfH
ynfK	ynfK
ynfL	ynfL
ynfM	ynfM
ynfN	ynfN
ynfO	ynfO
ynhF	ynhF
ynhG	ynhG
yniA	yniA
yniB	yniB
yniC	yniC
yniD	yniD
ynjA	ynjA
ynjB	ynjB
ynjC	ynjC
ynjD	ynjD
ynjE	ynjE
ynjF	ynjF
ynjH	ynjH
ynjI	ynjI
yoaA	yoaA
yoaB	yoaB
yoaC	yoaC
yoaD	yoaD
yoaE	yoaE
yoaF	yoaF
yoaG	yoaG
yoaH	yoaH
yoaI	yoaI
yobA	yobA
yobB	yobB
yobD	yobD
yobF	yobF
yobH	yobH
yodA	yodA
yodB	yodB
yodC	yodC
yodD	yodD
yoeA	yoeA
yoeB	yoeB
yoeF	yoeF
yoeG	yoeG
yohC	yohC
yohD	yohD
yohF	yohF
yohJ	yohJ
yohK	yohK
yohN	yohN
yohO	yohO
yojI	yojI
yojO	yojO
ypaA	ypaA
ypaB	ypaB
ypdA	ypdA
ypdB	ypdB
ypdC	ypdC
ypdE	ypdE
ypdF	ypdF
ypdI	ypdI
ypeA	ypeA
ypeB	ypeB
ypeC	ypeC
ypfG	ypfG
ypfH	ypfH
ypfI	ypfI
ypfJ	ypfJ
ypfM	ypfM
ypfN	ypfN
yphA	yphA
yphB	yphB
yphC	yphC
yphD	yphD
yphE	yphE
yphF	yphF
yphG	yphG
yphH	yphH
ypjA	ypjA
ypjC	ypjC
ypjD	ypjD
ypjF	ypjF
ypjI	ypjI
ypjJ	ypjJ
yqaA	yqaA
yqaB	yqaB
yqaE	yqaE
yqcA	yqcA
yqcC	yqcC
yqcE	yqcE
yqeA	yqeA
yqeB	yqeB
yqeC	yqeC
yqeF	yqeF
yqeG	yqeG
yqeH	yqeH
yqeI	yqeI
yqeJ	yqeJ
yqeK	yqeK
yqfA	yqfA
yqfB	yqfB
yqfE	yqfE
yqgA	yqgA
yqgB	yqgB
yqgC	yqgC
yqgD	yqgD
yqgE	yqgE
yqgF	yqgF
yqhA	yqhA
yqhC	yqhC
yqhD	yqhD
yqhG	yqhG
yqhH	yqhH
yqiA	yqiA
yqiB	yqiB
yqiC	yqiC
yqiG	yqiG
yqiH	yqiH
yqiI	yqiI
yqiJ	yqiJ
yqiK	yqiK
yqjA	yqjA
yqjB	yqjB
yqjC	yqjC
yqjD	yqjD
yqjE	yqjE
yqjF	yqjF
yqjG	yqjG
yqjH	yqjH
yqjI	yqjI
yqjK	yqjK
yraH	yraH
yraI	yraI
yraJ	yraJ
yraK	yraK
yraL	yraL
yraM	yraM
yraN	yraN
yraP	yraP
yraQ	yraQ
yraR	yraR
yrbA	yrbA
yrbB	yrbB
yrbC	yrbC
yrbD	yrbD
yrbE	yrbE
yrbF	yrbF
yrbG	yrbG
yrbK	yrbK
yrbL	yrbL
yrdA	yrdA
yrdB	yrdB
yrdD	yrdD
yrfF	yrfF
yrfG	yrfG
yrhA	yrhA
yrhB	yrhB
yrhC	yrhC
yrhD	yrhD
ysaA	ysaA
ysaB	ysaB
ysaC	ysaC
ysaD	ysaD
ysgA	ysgA
ytcA	ytcA
ytfA	ytfA
ytfB	ytfB
ytfE	ytfE
ytfF	ytfF
ytfG	ytfG
ytfH	ytfH
ytfI	ytfI
ytfJ	ytfJ
ytfK	ytfK
ytfL	ytfL
ytfM	ytfM
ytfN	ytfN
ytfP	ytfP
ytfQ	ytfQ
ytfR	ytfR
ytfT	ytfT
ythA	ythA
ytjA	ytjA
ytjB	ytjB
ytjC	ytjC
yzgL	yzgL
zapA	zapA
zipA	zipA
zitB	zitB
zntA	zntA
zntR	zntR
znuA	znuA
znuB	znuB
znuC	znuC
zraP	zraP
zraR	zraR
zraS	zraS
zupT	zupT
zur	zur
zwf	zwf
