tyrR	tyrR
glpR	glpR
tdcA	tdcA
allS	allS
mtlR	mtlR
treR	treR
adiY	adiY
cysB	cysB
decoy15	decoy15
hcaR	hcaR
modE	modE
oxyR	oxyR
glnG	glnG
nemR	nemR
bglJ	bglJ
rcsA	rcsA
lysR	lysR
yoeB	yoeB
glcC	glcC
cspA	cspA
mntR	mntR
glrR	glrR
cbl	cbl
ada	ada
putA	putA
agaR	agaR
rhaR	rhaR
sdiA	sdiA
decoy10	decoy10
dicA	dicA
ydeO	ydeO
caiF	caiF
envR	envR
slyA	slyA
nac	nac
gatR_1	gatR_1
rob	rob
baeR	baeR
dgsA	dgsA
decoy13	decoy13
deoR	deoR
rtcR	rtcR
fruR	fruR
phoB	phoB
mhpR	mhpR
decoy8	decoy8
decoy17	decoy17
lexA	lexA
hupB	hupB
torR	torR
gntR	gntR
soxS	soxS
xapR	xapR
kdgR	kdgR
stpA	stpA
decoy16	decoy16
rhaS	rhaS
malT	malT
nrdR	nrdR
decoy6	decoy6
decoy5	decoy5
prpR	prpR
gutM	gutM
csiR	csiR
rcnR	rcnR
appY	appY
decoy1	decoy1
metR	metR
pspF	pspF
lrhA	lrhA
trpR	trpR
yeiL	yeiL
fucR	fucR
soxR	soxR
fadR	fadR
exuR	exuR
qseB	qseB
fur	fur
hipA	hipA
chbR	chbR
creB	creB
gcvA	gcvA
metJ	metJ
fnr	fnr
hipB	hipB
uidR	uidR
envY	envY
nagC	nagC
decoy11	decoy11
asnC	asnC
yiaJ	yiaJ
purR	purR
murR	murR
pepA	pepA
argR	argR
galR	galR
araC	araC
cusR	cusR
gadW	gadW
phoP	phoP
fhlA	fhlA
mqsA	mqsA
iclR	iclR
yefM	yefM
uhpA	uhpA
lldR	lldR
mngR	mngR
dsdC	dsdC
csgD	csgD
nsrR	nsrR
cueR	cueR
cynR	cynR
melR	melR
decoy12	decoy12
flhC	flhC
rstA	rstA
rbsR	rbsR
gatR_2	gatR_2
flhD	flhD
crp	crp
arcA	arcA
ompR	ompR
nanR	nanR
decoy3	decoy3
ilvY	ilvY
gadE	gadE
rpiR	rpiR
evgA	evgA
gadX	gadX
alpA	alpA
betI	betI
ascG	ascG
rutR	rutR
leuO	leuO
galS	galS
hns	hns
cytR	cytR
paaX	paaX
nikR	nikR
ulaR	ulaR
ihfA	ihfA
idnR	idnR
sgrR	sgrR
iscR	iscR
relB	relB
lacI	lacI
alaS	alaS
decoy4	decoy4
nadR	nadR
dcuR	dcuR
kdpE	kdpE
xylR	xylR
cadC	cadC
atoC	atoC
mprA	mprA
pdhR	pdhR
decoy9	decoy9
allR	allR
hdfR	hdfR
narP	narP
argP	argP
bolA	bolA
zur	zur
lsrR	lsrR
marA	marA
decoy14	decoy14
cdaR	cdaR
tdcR	tdcR
hupA	hupA
rcsB	rcsB
fis	fis
decoy2	decoy2
mqsR	mqsR
dhaR	dhaR
relE	relE
narL	narL
acrR	acrR
norR	norR
marR	marR
fabR	fabR
feaR	feaR
cpxR	cpxR
arsR	arsR
hyfR	hyfR
zntR	zntR
srlR	srlR
lrp	lrp
nhaR	nhaR
malI	malI
decoy7	decoy7
birA	birA
dnaA	dnaA
zraR	zraR
ihfB	ihfB
uxuR	uxuR
uxaC	uxaC
rffD	rffD
mdtC	mdtC
argF	argF
truB	truB
rcnA	rcnA
ftsK	ftsK
aceB	aceB
decoy58	decoy58
cysN	cysN
fixB	fixB
decoy21	decoy21
phnD	phnD
decoy48	decoy48
rhaB	rhaB
hcaB	hcaB
rutE	rutE
rrlA	rrlA
decoy62	decoy62
dsbC	dsbC
lysU	lysU
prfA	prfA
rffM	rffM
pheV	pheV
purM	purM
argD	argD
fadI	fadI
allC	allC
fliN	fliN
pepT	pepT
yebE	yebE
gdhA	gdhA
dcuS	dcuS
mhpT	mhpT
gcvP	gcvP
paaB	paaB
ompA	ompA
apaH	apaH
tnaC	tnaC
mtlA	mtlA
fadE	fadE
lysA	lysA
entA	entA
uidC	uidC
ftnA	ftnA
gapA	gapA
hisM	hisM
yhdW	yhdW
sufS	sufS
epd	epd
bioA	bioA
metF	metF
nfo	nfo
aslB	aslB
hyaD	hyaD
caiT	caiT
emrK	emrK
ruvB	ruvB
yfiD	yfiD
pspB	pspB
malF	malF
cyaA	cyaA
nohA	nohA
allE	allE
rpiB	rpiB
fdnI	fdnI
fepC	fepC
kbl	kbl
ygiA	ygiA
queA	queA
yecR	yecR
setA	setA
puuA	puuA
glnW	glnW
rnpB	rnpB
betT	betT
ydeA	ydeA
smtA	smtA
nupG	nupG
decoy57	decoy57
hypE	hypE
ydbD	ydbD
rtcB	rtcB
garD	garD
napB	napB
decoy24	decoy24
galT	galT
hemF	hemF
bcsB	bcsB
cysA	cysA
acrD	acrD
rimM	rimM
idnD	idnD
bioC	bioC
xdhA	xdhA
folA	folA
fumB	fumB
narH	narH
nrdB	nrdB
ybbY	ybbY
recN	recN
gltK	gltK
alaT	alaT
hcaD	hcaD
melB	melB
argT	argT
tolC	tolC
acs	acs
znuB	znuB
ilvD	ilvD
rpoD	rpoD
argH	argH
wcaB	wcaB
cpxP	cpxP
glcE	glcE
ykgO	ykgO
tomB	tomB
uxaB	uxaB
phnI	phnI
moaA	moaA
csgE	csgE
hycG	hycG
proX	proX
hycH	hycH
gor	gor
chpR	chpR
dhaM	dhaM
sgbU	sgbU
motB	motB
yiaO	yiaO
yfdZ	yfdZ
yneN	yneN
phoA	phoA
yjbH	yjbH
kbaY	kbaY
cydD	cydD
cdd	cdd
serT	serT
gltA	gltA
idnK	idnK
fadB	fadB
aceE	aceE
kdpC	kdpC
yjjP	yjjP
serX	serX
purE	purE
ycaC	ycaC
nirC	nirC
rseC	rseC
yeiT	yeiT
cysC	cysC
ksgA	ksgA
nuoN	nuoN
fliO	fliO
hyfF	hyfF
emrA	emrA
emrB	emrB
alsB	alsB
scpC	scpC
sulA	sulA
prs	prs
gyrB	gyrB
purN	purN
malG	malG
prpB	prpB
purB	purB
dadA	dadA
nuoL	nuoL
ybjN	ybjN
ftsQ	ftsQ
lamB	lamB
hybC	hybC
phnO	phnO
ydhT	ydhT
nrdF	nrdF
rutG	rutG
ydhW	ydhW
hydN	hydN
flgG	flgG
infB	infB
glmY	glmY
hypB	hypB
flgB	flgB
wzyE	wzyE
ilvI	ilvI
cueO	cueO
rrsE	rrsE
glxR	glxR
phnM	phnM
fepD	fepD
trxA	trxA
ddpD	ddpD
nuoB	nuoB
glnX	glnX
hycE	hycE
oppB	oppB
ptsG	ptsG
phnG	phnG
nrfF	nrfF
dicB	dicB
sohB	sohB
lpxA	lpxA
ftsL	ftsL
thrV	thrV
tauA	tauA
leuA	leuA
artM	artM
fucI	fucI
ilvH	ilvH
ddpX	ddpX
guaA	guaA
ppdB	ppdB
znuA	znuA
gltX	gltX
rutB	rutB
ygbA	ygbA
gntP	gntP
gpmA	gpmA
decoy40	decoy40
rpoS	rpoS
fimB	fimB
yciE	yciE
dmsD	dmsD
decoy75	decoy75
araH	araH
tsgA	tsgA
inaA	inaA
hybD	hybD
fixC	fixC
rrlC	rrlC
leuB	leuB
emrY	emrY
apaG	apaG
nfuA	nfuA
ecpD	ecpD
garP	garP
fruA	fruA
poxB	poxB
chbC	chbC
zntA	zntA
cvpA	cvpA
intA	intA
moaC	moaC
alsA	alsA
cusS	cusS
rplD	rplD
dinF	dinF
gatZ	gatZ
yjeP	yjeP
csgF	csgF
gudX	gudX
sucC	sucC
mukB	mukB
ygbK	ygbK
arsC	arsC
thrU	thrU
nrdH	nrdH
decoy45	decoy45
rplC	rplC
proP	proP
glyU	glyU
mhpD	mhpD
fucP	fucP
astE	astE
trpC	trpC
dsbG	dsbG
dinQ	dinQ
fldB	fldB
frdA	frdA
ccmA	ccmA
alsC	alsC
malQ	malQ
ubiG	ubiG
gltT	gltT
argB	argB
trpA	trpA
xylB	xylB
ydhX	ydhX
ackA	ackA
dcuD	dcuD
mntH	mntH
decoy22	decoy22
ilvB	ilvB
nfsA	nfsA
glcA	glcA
fimI	fimI
paaH	paaH
gltV	gltV
iraP	iraP
cysJ	cysJ
phnH	phnH
rbsD	rbsD
leuQ	leuQ
fliS	fliS
napH	napH
yhdZ	yhdZ
gcd	gcd
ychO	ychO
prpD	prpD
mglC	mglC
treC	treC
grxA	grxA
hcaC	hcaC
aroP	aroP
cheA	cheA
agaV	agaV
codA	codA
frdB	frdB
dusB	dusB
norW	norW
aceF	aceF
chbF	chbF
glnB	glnB
nanC	nanC
tdcG	tdcG
hmp	hmp
rrlE	rrlE
tfaQ	tfaQ
nfsB	nfsB
hybB	hybB
nanK	nanK
phoQ	phoQ
yafP	yafP
amn	amn
katE	katE
yccB	yccB
ppdC	ppdC
cydB	cydB
dcuC	dcuC
decoy46	decoy46
yfdX	yfdX
rffT	rffT
pyrC	pyrC
ivbL	ivbL
dmsA	dmsA
cusC	cusC
hofO	hofO
fucA	fucA
cheY	cheY
decoy35	decoy35
decoy68	decoy68
yafN	yafN
fliJ	fliJ
fecD	fecD
sucD	sucD
rpsP	rpsP
ansB	ansB
mltF	mltF
kbaZ	kbaZ
ydeJ	ydeJ
osmE	osmE
hofN	hofN
copA	copA
csgB	csgB
hyaE	hyaE
iscS	iscS
argG	argG
folE	folE
guaB	guaB
fixA	fixA
ssuD	ssuD
fliT	fliT
ygaC	ygaC
mngB	mngB
mukF	mukF
scpA	scpA
valX	valX
cysI	cysI
mnmG	mnmG
fepE	fepE
yeaE	yeaE
yfhB	yfhB
pck	pck
rplV	rplV
iscA	iscA
xseA	xseA
motA	motA
glcB	glcB
ydeH	ydeH
phnP	phnP
valU	valU
xylF	xylF
rbsC	rbsC
mpl	mpl
tyrV	tyrV
tufB	tufB
hslJ	hslJ
decoy60	decoy60
yhdX	yhdX
uvrC	uvrC
ryhB	ryhB
fliH	fliH
fecE	fecE
mgrB	mgrB
rpsI	rpsI
metC	metC
nuoK	nuoK
ssb	ssb
fecA	fecA
decoy23	decoy23
decoy18	decoy18
psiE	psiE
fliP	fliP
hcp	hcp
ydjM	ydjM
glgS	glgS
cheR	cheR
manX	manX
rstB	rstB
recX	recX
pagP	pagP
gntU	gntU
rrfC	rrfC
mzrA	mzrA
ppiA	ppiA
rrsG	rrsG
cpdB	cpdB
uspB	uspB
ompW	ompW
gabT	gabT
ynfF	ynfF
phnK	phnK
sgbE	sgbE
fhuA	fhuA
paaG	paaG
rrsD	rrsD
psd	psd
agaD	agaD
ydeP	ydeP
dacC	dacC
dnaN	dnaN
ykgR	ykgR
cheB	cheB
sufB	sufB
rrsH	rrsH
csiD	csiD
rfe	rfe
ahpF	ahpF
yidQ	yidQ
tyrU	tyrU
zwf	zwf
msrA	msrA
phoR	phoR
glmS	glmS
entH	entH
flgJ	flgJ
gntK	gntK
modA	modA
adhE	adhE
rutD	rutD
glnP	glnP
agaS	agaS
gatD	gatD
flgD	flgD
phnF	phnF
entF	entF
alsE	alsE
hofB	hofB
wzzE	wzzE
potH	potH
relA	relA
narI	narI
cadB	cadB
sbmC	sbmC
focB	focB
leuT	leuT
ybdN	ybdN
glpD	glpD
ubiA	ubiA
fliE	fliE
ampC	ampC
ptsH	ptsH
decoy34	decoy34
ycgR	ycgR
dadX	dadX
frc	frc
lpxD	lpxD
borD	borD
yeaH	yeaH
galK	galK
sdhD	sdhD
lacZ	lacZ
lsrD	lsrD
pspE	pspE
decoy30	decoy30
hemH	hemH
rpmI	rpmI
ilvC	ilvC
deoB	deoB
ydhY	ydhY
serC	serC
yciG	yciG
acnA	acnA
fhuC	fhuC
ydfD	ydfD
ribA	ribA
feoA	feoA
leuX	leuX
acnB	acnB
fdnG	fdnG
allA	allA
sucB	sucB
symE	symE
moaD	moaD
rpsU	rpsU
decoy47	decoy47
glpX	glpX
fliC	fliC
xapA	xapA
yeiB	yeiB
deoC	deoC
argO	argO
decoy37	decoy37
flgM	flgM
cusF	cusF
umuD	umuD
ulaE	ulaE
nrdG	nrdG
malK	malK
lsrC	lsrC
ftsW	ftsW
trxC	trxC
decoy32	decoy32
dinG	dinG
ibpB	ibpB
cspD	cspD
glnA	glnA
nuoC	nuoC
nanE	nanE
cheZ	cheZ
mukE	mukE
sufE	sufE
glpG	glpG
nuoG	nuoG
mhpC	mhpC
rhaT	rhaT
dppD	dppD
glcF	glcF
livF	livF
lysV	lysV
nikE	nikE
livK	livK
ubiX	ubiX
csiE	csiE
mhpB	mhpB
agaC	agaC
cheW	cheW
rrsC	rrsC
erpA	erpA
hyaF	hyaF
dps	dps
hycB	hycB
thiQ	thiQ
ddpA	ddpA
hisQ	hisQ
hyi	hyi
lon	lon
tehA	tehA
fliM	fliM
rpoH	rpoH
trpL	trpL
cstA	cstA
sra	sra
rrfE	rrfE
hybO	hybO
kdpB	kdpB
aidB	aidB
dsbA	dsbA
valT	valT
azuC	azuC
ndh	ndh
fpr	fpr
ybdZ	ybdZ
flgN	flgN
hpt	hpt
hyfE	hyfE
atoD	atoD
cysM	cysM
metL	metL
nuoF	nuoF
pnuC	pnuC
tauD	tauD
pflB	pflB
ssuE	ssuE
purH	purH
rffA	rffA
fdnH	fdnH
decoy65	decoy65
gadA	gadA
lldD	lldD
arsB	arsB
yccA	yccA
mdtB	mdtB
lsrA	lsrA
gatB	gatB
rrlD	rrlD
mgtA	mgtA
norV	norV
manY	manY
nupC	nupC
micF	micF
topA	topA
csgC	csgC
yjcH	yjcH
glnV	glnV
appB	appB
lysW	lysW
lhgO	lhgO
gcvB	gcvB
potG	potG
fhuF	fhuF
polA	polA
lpd	lpd
gltI	gltI
hokD	hokD
gcvT	gcvT
upp	upp
hofM	hofM
nrfG	nrfG
gudD	gudD
mioC	mioC
prpC	prpC
dppF	dppF
metK	metK
mtlD	mtlD
phoH	phoH
rtcA	rtcA
ssuC	ssuC
mdtE	mdtE
osmC	osmC
alaW	alaW
dsdX	dsdX
tdcF	tdcF
moaB	moaB
kdpF	kdpF
ascF	ascF
rrfB	rrfB
rutC	rutC
srlD	srlD
uvrB	uvrB
uidA	uidA
uof	uof
decoy74	decoy74
tap	tap
ddlB	ddlB
spy	spy
acrB	acrB
cysD	cysD
rpsJ	rpsJ
rbfA	rbfA
atoB	atoB
ybfE	ybfE
galP	galP
speC	speC
nuoM	nuoM
nrfD	nrfD
gntT	gntT
wcaA	wcaA
gatY	gatY
uidB	uidB
idnO	idnO
asr	asr
lacA	lacA
katG	katG
hyfC	hyfC
gyrA	gyrA
lsrK	lsrK
rpsS	rpsS
xylG	xylG
purF	purF
flgF	flgF
ccmE	ccmE
phnN	phnN
sodB	sodB
ddpC	ddpC
decoy69	decoy69
dppB	dppB
ilvE	ilvE
pgaB	pgaB
ybaS	ybaS
nadB	nadB
smpA	smpA
paaK	paaK
cynT	cynT
malX	malX
uraA	uraA
alaV	alaV
fruB	fruB
galM	galM
metN	metN
nrfE	nrfE
aceA	aceA
ftsA	ftsA
hyaA	hyaA
bcsZ	bcsZ
pfkA	pfkA
trmD	trmD
fepB	fepB
entB	entB
frdC	frdC
napF	napF
uxuA	uxuA
malE	malE
lacY	lacY
tpr	tpr
ulaA	ulaA
prpE	prpE
fimF	fimF
araF	araF
decoy59	decoy59
proW	proW
hycA	hycA
proM	proM
metE	metE
hypA	hypA
yhjH	yhjH
decoy49	decoy49
entD	entD
ilvA	ilvA
bglB	bglB
hisR	hisR
thrT	thrT
grxD	grxD
aroG	aroG
trmA	trmA
spf	spf
livM	livM
fabZ	fabZ
entE	entE
sdaA	sdaA
dmsB	dmsB
znuC	znuC
udp	udp
tam	tam
ppdD	ppdD
hlpA	hlpA
gabP	gabP
bglF	bglF
nirB	nirB
ysgA	ysgA
aroL	aroL
cysP	cysP
pgaC	pgaC
xdhB	xdhB
ogt	ogt
cysU	cysU
iscU	iscU
eda	eda
manZ	manZ
yhfA	yhfA
trpD	trpD
pitB	pitB
nagA	nagA
cyoE	cyoE
uspA	uspA
marB	marB
ccmC	ccmC
xdhC	xdhC
ugpE	ugpE
uvrA	uvrA
ygiC	ygiC
fadJ	fadJ
dksA	dksA
rybB	rybB
ulaF	ulaF
fucO	fucO
bioB	bioB
hofP	hofP
hypD	hypD
insK	insK
tar	tar
livH	livH
decoy61	decoy61
dkgB	dkgB
hycI	hycI
yhcH	yhcH
murG	murG
puuD	puuD
tauC	tauC
fumC	fumC
metA	metA
glnH	glnH
pgm	pgm
iraD	iraD
ychH	ychH
uvrD	uvrD
oppC	oppC
ybaO	ybaO
purD	purD
aer	aer
gmr	gmr
sfsA	sfsA
mtr	mtr
ulaD	ulaD
trpB	trpB
actP	actP
purA	purA
rdoA	rdoA
psiF	psiF
hcaF	hcaF
rimP	rimP
ccmF	ccmF
rimK	rimK
leuL	leuL
tyrT	tyrT
exbD	exbD
thrW	thrW
glk	glk
ulaC	ulaC
phnE	phnE
tisB	tisB
uxuB	uxuB
tsx	tsx
ccmD	ccmD
ubiC	ubiC
fepA	fepA
bdm	bdm
tonB	tonB
caiC	caiC
phnJ	phnJ
dinB	dinB
rplW	rplW
araG	araG
ygiB	ygiB
argA	argA
rffC	rffC
nrdE	nrdE
modC	modC
aldB	aldB
leuD	leuD
argI	argI
flhA	flhA
degP	degP
oppD	oppD
putP	putP
decoy52	decoy52
decoy76	decoy76
phoU	phoU
crr	crr
lsrB	lsrB
livJ	livJ
argU	argU
decoy25	decoy25
speA	speA
decoy44	decoy44
gadC	gadC
flgC	flgC
hemA	hemA
nuoE	nuoE
ugpC	ugpC
entS	entS
ptsI	ptsI
oppF	oppF
valY	valY
gnd	gnd
tpx	tpx
artP	artP
rseB	rseB
decoy71	decoy71
ccmB	ccmB
yqjI	yqjI
amiA	amiA
flxA	flxA
hybE	hybE
purL	purL
mdtA	mdtA
zinT	zinT
ompC	ompC
yjbG	yjbG
puuR	puuR
grpE	grpE
proL	proL
fecR	fecR
xapB	xapB
glpF	glpF
decoy53	decoy53
hyfI	hyfI
artQ	artQ
pheS	pheS
recC	recC
dppA	dppA
decoy27	decoy27
ytfE	ytfE
gltL	gltL
hyfG	hyfG
paaD	paaD
allB	allB
tadA	tadA
asnB	asnB
tbpA	tbpA
bglG	bglG
hyaB	hyaB
murF	murF
fimD	fimD
ykgM	ykgM
asnA	asnA
gspO	gspO
araE	araE
fepG	fepG
glyT	glyT
hisJ	hisJ
ybbW	ybbW
yhhY	yhhY
dinJ	dinJ
decoy28	decoy28
hofC	hofC
slyB	slyB
murC	murC
hcr	hcr
argW	argW
argC	argC
gltB	gltB
nanM	nanM
csgA	csgA
glpE	glpE
malM	malM
fimH	fimH
tppB	tppB
cydA	cydA
pgi	pgi
mglA	mglA
moeB	moeB
srlA	srlA
hchA	hchA
uvrY	uvrY
pyrD	pyrD
ulaB	ulaB
ssuA	ssuA
astB	astB
aroM	aroM
glmU	glmU
metH	metH
fliF	fliF
ybaT	ybaT
aroF	aroF
dppC	dppC
rrfF	rrfF
nusA	nusA
rprA	rprA
hycF	hycF
glxK	glxK
fliQ	fliQ
gudP	gudP
mhpE	mhpE
zraP	zraP
hflD	hflD
ygdB	ygdB
murP	murP
napD	napD
hypC	hypC
cynX	cynX
tnaA	tnaA
fimC	fimC
gatA	gatA
srlE	srlE
rrsB	rrsB
fliG	fliG
glpC	glpC
sucA	sucA
atoE	atoE
artI	artI
nrdI	nrdI
feaB	feaB
srlB	srlB
ssuB	ssuB
araA	araA
tyrB	tyrB
creD	creD
ascB	ascB
malS	malS
decoy26	decoy26
cusB	cusB
appA	appA
caiD	caiD
metY	metY
pqiA	pqiA
ynfE	ynfE
ppdA	ppdA
decoy29	decoy29
decoy64	decoy64
araJ	araJ
glpK	glpK
ftsI	ftsI
leuV	leuV
decoy73	decoy73
cysH	cysH
nagE	nagE
ydiV	ydiV
murE	murE
pheU	pheU
glgA	glgA
paaI	paaI
hlyE	hlyE
sufD	sufD
xylA	xylA
omrA	omrA
sufA	sufA
yibD	yibD
envZ	envZ
gltD	gltD
ilvL	ilvL
glgC	glgC
lsrF	lsrF
gltJ	gltJ
alaX	alaX
dctA	dctA
pykF	pykF
nirD	nirD
rfaZ	rfaZ
yhjA	yhjA
hdeA	hdeA
rbsK	rbsK
rrfH	rrfH
betA	betA
ftnB	ftnB
caiA	caiA
rfaY	rfaY
ydfN	ydfN
ahpC	ahpC
hybG	hybG
decoy39	decoy39
ecnB	ecnB
pnp	pnp
appC	appC
pspD	pspD
glpA	glpA
deoA	deoA
hypF	hypF
artJ	artJ
chbB	chbB
ilvX	ilvX
narX	narX
ppiD	ppiD
yjbF	yjbF
nrfA	nrfA
decoy38	decoy38
hybF	hybF
nuoJ	nuoJ
mdtD	mdtD
napC	napC
napG	napG
yiaM	yiaM
ccmG	ccmG
fbaA	fbaA
galE	galE
ftsZ	ftsZ
tehB	tehB
flu	flu
argK	argK
rplP	rplP
rplM	rplM
uhpT	uhpT
yoaG	yoaG
recF	recF
narK	narK
yebG	yebG
tdcB	tdcB
yjeV	yjeV
livG	livG
adrA	adrA
alkA	alkA
dhaL	dhaL
nhaA	nhaA
evgS	evgS
dapB	dapB
hisP	hisP
ynfK	ynfK
glpB	glpB
yiaK	yiaK
pqiB	pqiB
hdeD	hdeD
glnK	glnK
sgrS	sgrS
glyA	glyA
proK	proK
metB	metB
rrfG	rrfG
glcG	glcG
trpE	trpE
dcuA	dcuA
htrE	htrE
rpoE	rpoE
glpQ	glpQ
decoy56	decoy56
rffH	rffH
csgG	csgG
cydC	cydC
yjbE	yjbE
ydhV	ydhV
fecB	fecB
decoy31	decoy31
speB	speB
tdcC	tdcC
rutA	rutA
phnL	phnL
pitA	pitA
yiaN	yiaN
cynS	cynS
cirA	cirA
fadA	fadA
carB	carB
acrA	acrA
fimG	fimG
agaI	agaI
gspB	gspB
atoA	atoA
yaiA	yaiA
bacA	bacA
aldA	aldA
decoy41	decoy41
gltF	gltF
fumA	fumA
ilvN	ilvN
ybiS	ybiS
nuoA	nuoA
fiu	fiu
hcaE	hcaE
infC	infC
argX	argX
glnQ	glnQ
caiE	caiE
yafQ	yafQ
flgI	flgI
hokE	hokE
paaE	paaE
rhaD	rhaD
cyoD	cyoD
tdh	tdh
gabD	gabD
pstB	pstB
ynfH	ynfH
ygjG	ygjG
garR	garR
wzxE	wzxE
ynfG	ynfG
eno	eno
focA	focA
ompF	ompF
metT	metT
pncB	pncB
fecI	fecI
decoy78	decoy78
nadA	nadA
ileT	ileT
fliL	fliL
allD	allD
caiB	caiB
hyfA	hyfA
cspI	cspI
decoy70	decoy70
torA	torA
rpmC	rpmC
bioF	bioF
garL	garL
rutF	rutF
nagB	nagB
fimA	fimA
yjjQ	yjjQ
fixX	fixX
tsr	tsr
yeaG	yeaG
cyoC	cyoC
gcvH	gcvH
gcl	gcl
flgE	flgE
dinD	dinD
torC	torC
tyrP	tyrP
sodA	sodA
yqjA	yqjA
murD	murD
astA	astA
nikA	nikA
mdtF	mdtF
glcD	glcD
rrlG	rrlG
rbsA	rbsA
rrlH	rrlH
yhdY	yhdY
nrfB	nrfB
rplS	rplS
rpsC	rpsC
wzb	wzb
icd	icd
wza	wza
nrdD	nrdD
pgaA	pgaA
paaJ	paaJ
fruK	fruK
tnaB	tnaB
fhuE	fhuE
decoy63	decoy63
rffG	rffG
gadY	gadY
nikD	nikD
phr	phr
sgbH	sgbH
ugpB	ugpB
fliY	fliY
cysK	cysK
lldP	lldP
gadB	gadB
cho	cho
sdhC	sdhC
decoy72	decoy72
treB	treB
moeA	moeA
ppsA	ppsA
ilvM	ilvM
ulaG	ulaG
pepD	pepD
fes	fes
rrsA	rrsA
rseA	rseA
fliD	fliD
yafO	yafO
lysT	lysT
iraM	iraM
aspA	aspA
chbA	chbA
fimE	fimE
hybA	hybA
hyaC	hyaC
mraY	mraY
aroH	aroH
nrfC	nrfC
glgP	glgP
malZ	malZ
rhaA	rhaA
leuP	leuP
yrbL	yrbL
tyrA	tyrA
napA	napA
decoy36	decoy36
alaU	alaU
argE	argE
glnU	glnU
aspV	aspV
ybbV	ybbV
ydiU	ydiU
leuW	leuW
alkB	alkB
fliK	fliK
xylH	xylH
osmB	osmB
slp	slp
gltU	gltU
trg	trg
astD	astD
yjgI	yjgI
hyfB	hyfB
flhB	flhB
ung	ung
pheM	pheM
gutQ	gutQ
decoy20	decoy20
baeS	baeS
fucU	fucU
metQ	metQ
rpsO	rpsO
exbB	exbB
aroA	aroA
maoC	maoC
cysW	cysW
gntX	gntX
narJ	narJ
ompX	ompX
ybjC	ybjC
ddpB	ddpB
paaF	paaF
hdeB	hdeB
yegR	yegR
pdxA	pdxA
nikB	nikB
hycD	hycD
scpB	scpB
exuT	exuT
fliA	fliA
dhaK	dhaK
ycfS	ycfS
lyxK	lyxK
cadA	cadA
hyfD	hyfD
chpA	chpA
ugpQ	ugpQ
mglB	mglB
pstS	pstS
mazG	mazG
ileV	ileV
fdhF	fdhF
decoy77	decoy77
gltW	gltW
umuC	umuC
pgaD	pgaD
pstC	pstC
pspA	pspA
tdcD	tdcD
phnC	phnC
thiP	thiP
rffE	rffE
rbsB	rbsB
acrE	acrE
uxaA	uxaA
fliZ	fliZ
chiA	chiA
pgk	pgk
decoy43	decoy43
seqA	seqA
tauB	tauB
ccmH	ccmH
pspC	pspC
chbG	chbG
yciF	yciF
garK	garK
yeaR	yeaR
acrF	acrF
phoE	phoE
flhE	flhE
paaC	paaC
cusA	cusA
dcuB	dcuB
nrdA	nrdA
cyaR	cyaR
narG	narG
fhuD	fhuD
decoy50	decoy50
melA	melA
araD	araD
hemL	hemL
purC	purC
fhuB	fhuB
fecC	fecC
potF	potF
dinI	dinI
flgA	flgA
decoy67	decoy67
ydhO	ydhO
deoD	deoD
dctR	dctR
lpxC	lpxC
tdcE	tdcE
adiA	adiA
fabB	fabB
fabA	fabA
cyoA	cyoA
decoy55	decoy55
leuC	leuC
rplB	rplB
glnL	glnL
malY	malY
fadD	fadD
nanT	nanT
frdD	frdD
idnT	idnT
carA	carA
rrfD	rrfD
agp	agp
polB	polB
modB	modB
hycC	hycC
hyfH	hyfH
recA	recA
nuoI	nuoI
cyoB	cyoB
decoy42	decoy42
oppA	oppA
proV	proV
ileU	ileU
rrlB	rrlB
qseC	qseC
serA	serA
araB	araB
cpxA	cpxA
ugpA	ugpA
hyfJ	hyfJ
nagD	nagD
amtB	amtB
hha	hha
fliI	fliI
decoy33	decoy33
ruvA	ruvA
malP	malP
yojI	yojI
rpsQ	rpsQ
entC	entC
dmsC	dmsC
omrB	omrB
sdhB	sdhB
htpG	htpG
aceK	aceK
sufC	sufC
decoy66	decoy66
dnaG	dnaG
yahA	yahA
ddpF	ddpF
mhpF	mhpF
mhpA	mhpA
metU	metU
ybjG	ybjG
torD	torD
purK	purK
bioD	bioD
nemA	nemA
rrfA	rrfA
glpT	glpT
cysG	cysG
nuoH	nuoH
decoy54	decoy54
agaB	agaB
fucK	fucK
kdpA	kdpA
codB	codB
zraS	zraS
wzc	wzc
astC	astC
dsdA	dsdA
fldA	fldA
lsrG	lsrG
nikC	nikC
edd	edd
feoB	feoB
sdhA	sdhA
yhiD	yhiD
gatC	gatC
betB	betB
pspG	pspG
yeiA	yeiA
mngA	mngA
rplT	rplT
thrS	thrS
ydhU	ydhU
metI	metI
decoy19	decoy19
moaE	moaE
nanA	nanA
pstA	pstA
pheT	pheT
prmC	prmC
yiaL	yiaL
decoy51	decoy51
flgH	flgH
murQ	murQ
fliR	fliR
mdh	mdh
fadL	fadL
paaA	paaA
osmY	osmY
potI	potI
